Airport,Year,Month,Date,Domestic Passengers,International Passengers,Total Passengers
Adelaide,2009,1,2009-01-01,517632,45113,562745
Adelaide,2009,2,2009-02-01,466920,36184,503104
Adelaide,2009,3,2009-03-01,565261,37620,602881
Adelaide,2009,4,2009-04-01,555522,41440,596962
Adelaide,2009,5,2009-05-01,517203,36406,553609
Adelaide,2009,6,2009-06-01,484873,37129,522002
Adelaide,2009,7,2009-07-01,542166,45352,587518
Adelaide,2009,8,2009-08-01,538835,40627,579462
Adelaide,2009,9,2009-09-01,531861,44738,576599
Adelaide,2009,10,2009-10-01,561466,47040,608506
Adelaide,2009,11,2009-11-01,531518,43449,574967
Adelaide,2009,12,2009-12-01,527091,46301,573392
Adelaide,2010,1,2010-01-01,519063,48805,567868
Adelaide,2010,2,2010-02-01,499819,38282,538101
Adelaide,2010,3,2010-03-01,586946,42695,629641
Adelaide,2010,4,2010-04-01,586710,45420,632130
Adelaide,2010,5,2010-05-01,541978,39331,581309
Adelaide,2010,6,2010-06-01,524575,41441,566016
Adelaide,2010,7,2010-07-01,590676,47178,637854
Adelaide,2010,8,2010-08-01,567307,43369,610676
Adelaide,2010,9,2010-09-01,569972,45753,615725
Adelaide,2010,10,2010-10-01,614845,46941,661786
Adelaide,2010,11,2010-11-01,568388,44046,612434
Adelaide,2010,12,2010-12-01,587933,49131,637064
Adelaide,2011,1,2011-01-01,549241,49494,598735
Adelaide,2011,2,2011-02-01,500762,40101,540863
Adelaide,2011,3,2011-03-01,589089,43138,632227
Adelaide,2011,4,2011-04-01,569555,48782,618337
Adelaide,2011,5,2011-05-01,548098,45314,593412
Adelaide,2011,6,2011-06-01,475053,44600,519653
Adelaide,2011,7,2011-07-01,550818,53391,604209
Adelaide,2011,8,2011-08-01,526160,49977,576137
Adelaide,2011,9,2011-09-01,523982,51072,575054
Adelaide,2011,10,2011-10-01,551110,52025,603135
Adelaide,2011,11,2011-11-01,531539,47928,579467
Adelaide,2011,12,2011-12-01,522927,57251,580178
Adelaide,2012,1,2012-01-01,519484,61737,581221
Adelaide,2012,2,2012-02-01,491820,47477,539297
Adelaide,2012,3,2012-03-01,559334,51632,610966
Adelaide,2012,4,2012-04-01,531241,51716,582957
Adelaide,2012,5,2012-05-01,526113,45236,571349
Adelaide,2012,6,2012-06-01,493715,49307,543022
Adelaide,2012,7,2012-07-01,545554,56268,601822
Adelaide,2012,8,2012-08-01,528411,49357,577768
Adelaide,2012,9,2012-09-01,540478,55038,595516
Adelaide,2012,10,2012-10-01,568726,53692,622418
Adelaide,2012,11,2012-11-01,568625,58625,627250
Adelaide,2012,12,2012-12-01,543314,69992,613306
Adelaide,2013,1,2013-01-01,528626,70248,598874
Adelaide,2013,2,2013-02-01,482351,57932,540283
Adelaide,2013,3,2013-03-01,566943,61224,628167
Adelaide,2013,4,2013-04-01,567813,63566,631379
Adelaide,2013,5,2013-05-01,523424,54908,578332
Adelaide,2013,6,2013-06-01,496963,58619,555582
Adelaide,2013,7,2013-07-01,575913,72764,648677
Adelaide,2013,8,2013-08-01,539644,64337,603981
Adelaide,2013,9,2013-09-01,545307,69573,614880
Adelaide,2013,10,2013-10-01,607419,68521,675940
Adelaide,2013,11,2013-11-01,558869,68082,626951
Adelaide,2013,12,2013-12-01,581017,89811,670828
Adelaide,2014,1,2014-01-01,556572,95325,651897
Adelaide,2014,2,2014-02-01,504053,69804,573857
Adelaide,2014,3,2014-03-01,581303,71212,652515
Adelaide,2014,4,2014-04-01,568388,82087,650475
Adelaide,2014,5,2014-05-01,536398,74345,610743
Adelaide,2014,6,2014-06-01,515982,80662,596644
Adelaide,2014,7,2014-07-01,573743,95610,669353
Adelaide,2014,8,2014-08-01,561222,80809,642031
Adelaide,2014,9,2014-09-01,557453,80741,638194
Adelaide,2014,10,2014-10-01,630681,79485,710166
Adelaide,2014,11,2014-11-01,558777,68976,627753
Adelaide,2014,12,2014-12-01,587027,88209,675236
Adelaide,2015,1,2015-01-01,544328,91141,635469
Adelaide,2015,2,2015-02-01,503965,69039,573004
Adelaide,2015,3,2015-03-01,585173,70810,655983
Adelaide,2015,4,2015-04-01,586146,70469,656615
Adelaide,2015,5,2015-05-01,542748,67667,610415
Adelaide,2015,6,2015-06-01,505461,70521,575982
Adelaide,2015,7,2015-07-01,598092,77188,675280
Adelaide,2015,8,2015-08-01,560021,70699,630720
Adelaide,2015,9,2015-09-01,563095,71100,634195
Adelaide,2015,10,2015-10-01,620527,72389,692916
Adelaide,2015,11,2015-11-01,590588,60841,651429
Adelaide,2015,12,2015-12-01,599637,79524,679161
Adelaide,2016,1,2016-01-01,566662,84427,651089
Adelaide,2016,2,2016-02-01,526882,64796,591678
Adelaide,2016,3,2016-03-01,604594,66425,671019
Adelaide,2016,4,2016-04-01,594187,67722,661909
Adelaide,2016,5,2016-05-01,563975,69012,632987
Adelaide,2016,6,2016-06-01,532273,73079,605352
Adelaide,2016,7,2016-07-01,607954,90683,698637
Adelaide,2016,8,2016-08-01,564253,79247,643500
Adelaide,2016,9,2016-09-01,582329,83152,665481
Adelaide,2016,10,2016-10-01,636290,81749,718039
Adelaide,2016,11,2016-11-01,610621,71003,681624
Adelaide,2016,12,2016-12-01,605974,92884,698858
Adelaide,2017,1,2017-01-01,587837,94277,682114
Adelaide,2017,2,2017-02-01,523949,68611,592560
Adelaide,2017,3,2017-03-01,621085,71109,692194
Adelaide,2017,4,2017-04-01,591139,73812,664951
Adelaide,2017,5,2017-05-01,570882,71121,642003
Adelaide,2017,6,2017-06-01,546124,73295,619419
Adelaide,2017,7,2017-07-01,619108,89712,708820
Adelaide,2017,8,2017-08-01,574943,82584,657527
Adelaide,2017,9,2017-09-01,591552,87033,678585
Adelaide,2017,10,2017-10-01,653560,82620,736180
Adelaide,2017,11,2017-11-01,627919,74418,702337
Adelaide,2017,12,2017-12-01,640861,94383,735244
Adelaide,2018,1,2018-01-01,604865,105584,710449
Adelaide,2018,2,2018-02-01,547363,73693,621056
Adelaide,2018,3,2018-03-01,638977,77493,716470
Adelaide,2018,4,2018-04-01,627977,77949,705926
Adelaide,2018,5,2018-05-01,589510,74528,664038
Adelaide,2018,6,2018-06-01,558369,78573,636942
Adelaide,2018,7,2018-07-01,638329,91266,729595
Adelaide,2018,8,2018-08-01,602934,87573,690507
Adelaide,2018,9,2018-09-01,601330,89394,690724
Adelaide,2018,10,2018-10-01,657363,88105,745468
Adelaide,2018,11,2018-11-01,633974,82278,716252
Adelaide,2018,12,2018-12-01,619350,99525,718875
Adelaide,2019,1,2019-01-01,592951,107476,700427
Adelaide,2019,2,2019-02-01,551355,80250,631605
Alice Springs,2009,1,2009-01-01,52040,0,52040
Alice Springs,2009,2,2009-02-01,45340,0,45340
Alice Springs,2009,3,2009-03-01,55685,0,55685
Alice Springs,2009,4,2009-04-01,57116,0,57116
Alice Springs,2009,5,2009-05-01,54641,0,54641
Alice Springs,2009,6,2009-06-01,54204,0,54204
Alice Springs,2009,7,2009-07-01,63630,0,63630
Alice Springs,2009,8,2009-08-01,62136,0,62136
Alice Springs,2009,9,2009-09-01,59804,0,59804
Alice Springs,2009,10,2009-10-01,63045,0,63045
Alice Springs,2009,11,2009-11-01,56109,0,56109
Alice Springs,2009,12,2009-12-01,51151,0,51151
Alice Springs,2010,1,2010-01-01,51424,0,51424
Alice Springs,2010,2,2010-02-01,47884,0,47884
Alice Springs,2010,3,2010-03-01,58601,0,58601
Alice Springs,2010,4,2010-04-01,58508,0,58508
Alice Springs,2010,5,2010-05-01,54695,0,54695
Alice Springs,2010,6,2010-06-01,54308,0,54308
Alice Springs,2010,7,2010-07-01,61986,0,61986
Alice Springs,2010,8,2010-08-01,60620,0,60620
Alice Springs,2010,9,2010-09-01,58603,0,58603
Alice Springs,2010,10,2010-10-01,60874,0,60874
Alice Springs,2010,11,2010-11-01,53219,0,53219
Alice Springs,2010,12,2010-12-01,48122,0,48122
Alice Springs,2011,1,2011-01-01,47486,0,47486
Alice Springs,2011,2,2011-02-01,43828,0,43828
Alice Springs,2011,3,2011-03-01,50398,0,50398
Alice Springs,2011,4,2011-04-01,55081,0,55081
Alice Springs,2011,5,2011-05-01,50605,0,50605
Alice Springs,2011,6,2011-06-01,49697,0,49697
Alice Springs,2011,7,2011-07-01,55314,0,55314
Alice Springs,2011,8,2011-08-01,51690,0,51690
Alice Springs,2011,9,2011-09-01,47709,0,47709
Alice Springs,2011,10,2011-10-01,52883,0,52883
Alice Springs,2011,11,2011-11-01,49003,0,49003
Alice Springs,2011,12,2011-12-01,45055,0,45055
Alice Springs,2012,1,2012-01-01,43218,0,43218
Alice Springs,2012,2,2012-02-01,41645,0,41645
Alice Springs,2012,3,2012-03-01,47137,0,47137
Alice Springs,2012,4,2012-04-01,47511,0,47511
Alice Springs,2012,5,2012-05-01,45930,0,45930
Alice Springs,2012,6,2012-06-01,48225,0,48225
Alice Springs,2012,7,2012-07-01,55120,0,55120
Alice Springs,2012,8,2012-08-01,52472,0,52472
Alice Springs,2012,9,2012-09-01,51409,0,51409
Alice Springs,2012,10,2012-10-01,52987,0,52987
Alice Springs,2012,11,2012-11-01,50249,0,50249
Alice Springs,2012,12,2012-12-01,43849,0,43849
Alice Springs,2013,1,2013-01-01,42504,0,42504
Alice Springs,2013,2,2013-02-01,39108,0,39108
Alice Springs,2013,3,2013-03-01,47342,0,47342
Alice Springs,2013,4,2013-04-01,52892,0,52892
Alice Springs,2013,5,2013-05-01,50160,0,50160
Alice Springs,2013,6,2013-06-01,57670,0,57670
Alice Springs,2013,7,2013-07-01,66751,0,66751
Alice Springs,2013,8,2013-08-01,64279,0,64279
Alice Springs,2013,9,2013-09-01,59611,0,59611
Alice Springs,2013,10,2013-10-01,66304,0,66304
Alice Springs,2013,11,2013-11-01,57429,0,57429
Alice Springs,2013,12,2013-12-01,51195,0,51195
Alice Springs,2014,1,2014-01-01,48329,0,48329
Alice Springs,2014,2,2014-02-01,45421,0,45421
Alice Springs,2014,3,2014-03-01,54122,0,54122
Alice Springs,2014,4,2014-04-01,55995,0,55995
Alice Springs,2014,5,2014-05-01,51841,0,51841
Alice Springs,2014,6,2014-06-01,56256,0,56256
Alice Springs,2014,7,2014-07-01,61763,0,61763
Alice Springs,2014,8,2014-08-01,55759,0,55759
Alice Springs,2014,9,2014-09-01,50835,0,50835
Alice Springs,2014,10,2014-10-01,53955,0,53955
Alice Springs,2014,11,2014-11-01,46199,0,46199
Alice Springs,2014,12,2014-12-01,40594,0,40594
Alice Springs,2015,1,2015-01-01,39279,0,39279
Alice Springs,2015,2,2015-02-01,39325,0,39325
Alice Springs,2015,3,2015-03-01,46890,0,46890
Alice Springs,2015,4,2015-04-01,50420,0,50420
Alice Springs,2015,5,2015-05-01,47291,0,47291
Alice Springs,2015,6,2015-06-01,50431,0,50431
Alice Springs,2015,7,2015-07-01,61048,0,61048
Alice Springs,2015,8,2015-08-01,57699,0,57699
Alice Springs,2015,9,2015-09-01,51752,0,51752
Alice Springs,2015,10,2015-10-01,54772,0,54772
Alice Springs,2015,11,2015-11-01,50498,0,50498
Alice Springs,2015,12,2015-12-01,44105,0,44105
Alice Springs,2016,1,2016-01-01,40548,0,40548
Alice Springs,2016,2,2016-02-01,42192,0,42192
Alice Springs,2016,3,2016-03-01,50308,0,50308
Alice Springs,2016,4,2016-04-01,49934,0,49934
Alice Springs,2016,5,2016-05-01,48299,0,48299
Alice Springs,2016,6,2016-06-01,51670,0,51670
Alice Springs,2016,7,2016-07-01,61281,0,61281
Alice Springs,2016,8,2016-08-01,57448,0,57448
Alice Springs,2016,9,2016-09-01,56261,0,56261
Alice Springs,2016,10,2016-10-01,57953,0,57953
Alice Springs,2016,11,2016-11-01,50336,0,50336
Alice Springs,2016,12,2016-12-01,45944,0,45944
Alice Springs,2017,1,2017-01-01,43990,0,43990
Alice Springs,2017,2,2017-02-01,41130,0,41130
Alice Springs,2017,3,2017-03-01,51969,0,51969
Alice Springs,2017,4,2017-04-01,51915,0,51915
Alice Springs,2017,5,2017-05-01,49198,0,49198
Alice Springs,2017,6,2017-06-01,49761,0,49761
Alice Springs,2017,7,2017-07-01,60269,0,60269
Alice Springs,2017,8,2017-08-01,57954,0,57954
Alice Springs,2017,9,2017-09-01,54335,0,54335
Alice Springs,2017,10,2017-10-01,57338,0,57338
Alice Springs,2017,11,2017-11-01,54558,0,54558
Alice Springs,2017,12,2017-12-01,46076,0,46076
Alice Springs,2018,1,2018-01-01,42375,0,42375
Alice Springs,2018,2,2018-02-01,41299,0,41299
Alice Springs,2018,3,2018-03-01,50973,0,50973
Alice Springs,2018,4,2018-04-01,48800,0,48800
Alice Springs,2018,5,2018-05-01,50014,0,50014
Alice Springs,2018,6,2018-06-01,51067,0,51067
Alice Springs,2018,7,2018-07-01,63687,0,63687
Alice Springs,2018,8,2018-08-01,60177,0,60177
Alice Springs,2018,9,2018-09-01,56698,0,56698
Alice Springs,2018,10,2018-10-01,58191,0,58191
Alice Springs,2018,11,2018-11-01,53006,0,53006
Alice Springs,2018,12,2018-12-01,45125,0,45125
Alice Springs,2019,1,2019-01-01,40274,0,40274
Alice Springs,2019,2,2019-02-01,39096,0,39096
Ballina,2009,1,2009-01-01,33053,0,33053
Ballina,2009,2,2009-02-01,28388,0,28388
Ballina,2009,3,2009-03-01,30284,0,30284
Ballina,2009,4,2009-04-01,28611,0,28611
Ballina,2009,5,2009-05-01,25987,0,25987
Ballina,2009,6,2009-06-01,24260,0,24260
Ballina,2009,7,2009-07-01,28074,0,28074
Ballina,2009,8,2009-08-01,21206,0,21206
Ballina,2009,9,2009-09-01,22373,0,22373
Ballina,2009,10,2009-10-01,25573,0,25573
Ballina,2009,11,2009-11-01,25227,0,25227
Ballina,2009,12,2009-12-01,25278,0,25278
Ballina,2010,1,2010-01-01,25493,0,25493
Ballina,2010,2,2010-02-01,21832,0,21832
Ballina,2010,3,2010-03-01,22620,0,22620
Ballina,2010,4,2010-04-01,20989,0,20989
Ballina,2010,5,2010-05-01,18641,0,18641
Ballina,2010,6,2010-06-01,17078,0,17078
Ballina,2010,7,2010-07-01,20393,0,20393
Ballina,2010,8,2010-08-01,20988,0,20988
Ballina,2010,9,2010-09-01,23167,0,23167
Ballina,2010,10,2010-10-01,26030,0,26030
Ballina,2010,11,2010-11-01,23095,0,23095
Ballina,2010,12,2010-12-01,28563,0,28563
Ballina,2011,1,2011-01-01,30918,0,30918
Ballina,2011,2,2011-02-01,23605,0,23605
Ballina,2011,3,2011-03-01,26052,0,26052
Ballina,2011,4,2011-04-01,26201,0,26201
Ballina,2011,5,2011-05-01,22065,0,22065
Ballina,2011,6,2011-06-01,20245,0,20245
Ballina,2011,7,2011-07-01,26161,0,26161
Ballina,2011,8,2011-08-01,23560,0,23560
Ballina,2011,9,2011-09-01,27135,0,27135
Ballina,2011,10,2011-10-01,27650,0,27650
Ballina,2011,11,2011-11-01,26149,0,26149
Ballina,2011,12,2011-12-01,30758,0,30758
Ballina,2012,1,2012-01-01,36030,0,36030
Ballina,2012,2,2012-02-01,23942,0,23942
Ballina,2012,3,2012-03-01,26249,0,26249
Ballina,2012,4,2012-04-01,30077,0,30077
Ballina,2012,5,2012-05-01,25097,0,25097
Ballina,2012,6,2012-06-01,23341,0,23341
Ballina,2012,7,2012-07-01,28479,0,28479
Ballina,2012,8,2012-08-01,26407,0,26407
Ballina,2012,9,2012-09-01,29738,0,29738
Ballina,2012,10,2012-10-01,32174,0,32174
Ballina,2012,11,2012-11-01,30169,0,30169
Ballina,2012,12,2012-12-01,34308,0,34308
Ballina,2013,1,2013-01-01,36651,0,36651
Ballina,2013,2,2013-02-01,23098,0,23098
Ballina,2013,3,2013-03-01,28128,0,28128
Ballina,2013,4,2013-04-01,33902,0,33902
Ballina,2013,5,2013-05-01,27718,0,27718
Ballina,2013,6,2013-06-01,28291,0,28291
Ballina,2013,7,2013-07-01,32257,0,32257
Ballina,2013,8,2013-08-01,28312,0,28312
Ballina,2013,9,2013-09-01,33967,0,33967
Ballina,2013,10,2013-10-01,36928,0,36928
Ballina,2013,11,2013-11-01,33262,0,33262
Ballina,2013,12,2013-12-01,39833,0,39833
Ballina,2014,1,2014-01-01,42349,0,42349
Ballina,2014,2,2014-02-01,30092,0,30092
Ballina,2014,3,2014-03-01,31747,0,31747
Ballina,2014,4,2014-04-01,34182,0,34182
Ballina,2014,5,2014-05-01,26762,0,26762
Ballina,2014,6,2014-06-01,29314,0,29314
Ballina,2014,7,2014-07-01,36122,0,36122
Ballina,2014,8,2014-08-01,29907,0,29907
Ballina,2014,9,2014-09-01,38883,0,38883
Ballina,2014,10,2014-10-01,39256,0,39256
Ballina,2014,11,2014-11-01,36277,0,36277
Ballina,2014,12,2014-12-01,39304,0,39304
Ballina,2015,1,2015-01-01,45436,0,45436
Ballina,2015,2,2015-02-01,31445,0,31445
Ballina,2015,3,2015-03-01,36086,0,36086
Ballina,2015,4,2015-04-01,39772,0,39772
Ballina,2015,5,2015-05-01,32153,0,32153
Ballina,2015,6,2015-06-01,32385,0,32385
Ballina,2015,7,2015-07-01,37513,0,37513
Ballina,2015,8,2015-08-01,34180,0,34180
Ballina,2015,9,2015-09-01,41641,0,41641
Ballina,2015,10,2015-10-01,44079,0,44079
Ballina,2015,11,2015-11-01,36701,0,36701
Ballina,2015,12,2015-12-01,43507,0,43507
Ballina,2016,1,2016-01-01,46906,0,46906
Ballina,2016,2,2016-02-01,36594,0,36594
Ballina,2016,3,2016-03-01,41689,0,41689
Ballina,2016,4,2016-04-01,39998,0,39998
Ballina,2016,5,2016-05-01,33665,0,33665
Ballina,2016,6,2016-06-01,32591,0,32591
Ballina,2016,7,2016-07-01,41880,0,41880
Ballina,2016,8,2016-08-01,33840,0,33840
Ballina,2016,9,2016-09-01,42665,0,42665
Ballina,2016,10,2016-10-01,47435,0,47435
Ballina,2016,11,2016-11-01,40335,0,40335
Ballina,2016,12,2016-12-01,50325,0,50325
Ballina,2017,1,2017-01-01,51901,0,51901
Ballina,2017,2,2017-02-01,36897,0,36897
Ballina,2017,3,2017-03-01,41070,0,41070
Ballina,2017,4,2017-04-01,48490,0,48490
Ballina,2017,5,2017-05-01,34202,0,34202
Ballina,2017,6,2017-06-01,33759,0,33759
Ballina,2017,7,2017-07-01,41496,0,41496
Ballina,2017,8,2017-08-01,33847,0,33847
Ballina,2017,9,2017-09-01,43990,0,43990
Ballina,2017,10,2017-10-01,49595,0,49595
Ballina,2017,11,2017-11-01,43054,0,43054
Ballina,2017,12,2017-12-01,51278,0,51278
Ballina,2018,1,2018-01-01,56662,0,56662
Ballina,2018,2,2018-02-01,41626,0,41626
Ballina,2018,3,2018-03-01,44689,0,44689
Ballina,2018,4,2018-04-01,47430,0,47430
Ballina,2018,5,2018-05-01,37390,0,37390
Ballina,2018,6,2018-06-01,35717,0,35717
Ballina,2018,7,2018-07-01,46180,0,46180
Ballina,2018,8,2018-08-01,40123,0,40123
Ballina,2018,9,2018-09-01,42966,0,42966
Ballina,2018,10,2018-10-01,50893,0,50893
Ballina,2018,11,2018-11-01,42984,0,42984
Ballina,2018,12,2018-12-01,51520,0,51520
Ballina,2019,1,2019-01-01,56463,0,56463
Ballina,2019,2,2019-02-01,38167,0,38167
Brisbane,2009,1,2009-01-01,1259327,377810,1637137
Brisbane,2009,2,2009-02-01,1039265,300696,1339961
Brisbane,2009,3,2009-03-01,1188065,314602,1502667
Brisbane,2009,4,2009-04-01,1213113,334341,1547454
Brisbane,2009,5,2009-05-01,1164256,303511,1467767
Brisbane,2009,6,2009-06-01,1137727,324138,1461865
Brisbane,2009,7,2009-07-01,1280886,372221,1653107
Brisbane,2009,8,2009-08-01,1224013,352997,1577010
Brisbane,2009,9,2009-09-01,1268630,358611,1627241
Brisbane,2009,10,2009-10-01,1331349,363767,1695116
Brisbane,2009,11,2009-11-01,1230897,335659,1566556
Brisbane,2009,12,2009-12-01,1258396,378818,1637214
Brisbane,2010,1,2010-01-01,1179826,376365,1556191
Brisbane,2010,2,2010-02-01,1091254,307242,1398496
Brisbane,2010,3,2010-03-01,1209259,330724,1539983
Brisbane,2010,4,2010-04-01,1248593,328411,1577004
Brisbane,2010,5,2010-05-01,1188698,307506,1496204
Brisbane,2010,6,2010-06-01,1222414,350420,1572834
Brisbane,2010,7,2010-07-01,1371029,408510,1779539
Brisbane,2010,8,2010-08-01,1328818,373435,1702253
Brisbane,2010,9,2010-09-01,1366862,380317,1747179
Brisbane,2010,10,2010-10-01,1417246,376457,1793703
Brisbane,2010,11,2010-11-01,1333772,346187,1679959
Brisbane,2010,12,2010-12-01,1380381,396683,1777064
Brisbane,2011,1,2011-01-01,1183437,396077,1579514
Brisbane,2011,2,2011-02-01,1104756,307099,1411855
Brisbane,2011,3,2011-03-01,1278582,310877,1589459
Brisbane,2011,4,2011-04-01,1319238,354928,1674166
Brisbane,2011,5,2011-05-01,1291627,334430,1626057
Brisbane,2011,6,2011-06-01,1258224,355774,1613998
Brisbane,2011,7,2011-07-01,1432602,421648,1854250
Brisbane,2011,8,2011-08-01,1391452,385201,1776653
Brisbane,2011,9,2011-09-01,1402267,391592,1793859
Brisbane,2011,10,2011-10-01,1433784,400390,1834174
Brisbane,2011,11,2011-11-01,1385030,364919,1749949
Brisbane,2011,12,2011-12-01,1407984,421932,1829916
Brisbane,2012,1,2012-01-01,1325342,417093,1742435
Brisbane,2012,2,2012-02-01,1198554,322927,1521481
Brisbane,2012,3,2012-03-01,1369715,340186,1709901
Brisbane,2012,4,2012-04-01,1344510,362914,1707424
Brisbane,2012,5,2012-05-01,1340158,320257,1660415
Brisbane,2012,6,2012-06-01,1322216,370945,1693161
Brisbane,2012,7,2012-07-01,1460227,405051,1865278
Brisbane,2012,8,2012-08-01,1433116,374187,1807303
Brisbane,2012,9,2012-09-01,1433166,388638,1821804
Brisbane,2012,10,2012-10-01,1514062,393092,1907154
Brisbane,2012,11,2012-11-01,1443020,359129,1802149
Brisbane,2012,12,2012-12-01,1417263,416994,1834257
Brisbane,2013,1,2013-01-01,1328867,403501,1732368
Brisbane,2013,2,2013-02-01,1200869,332613,1533482
Brisbane,2013,3,2013-03-01,1345737,364214,1709951
Brisbane,2013,4,2013-04-01,1356396,357847,1714243
Brisbane,2013,5,2013-05-01,1336670,339573,1676243
Brisbane,2013,6,2013-06-01,1352353,388140,1740493
Brisbane,2013,7,2013-07-01,1507955,425439,1933394
Brisbane,2013,8,2013-08-01,1450518,412072,1862590
Brisbane,2013,9,2013-09-01,1435802,412322,1848124
Brisbane,2013,10,2013-10-01,1543562,413769,1957331
Brisbane,2013,11,2013-11-01,1436535,376923,1813458
Brisbane,2013,12,2013-12-01,1480433,442728,1923161
Brisbane,2014,1,2014-01-01,1372181,441534,1813715
Brisbane,2014,2,2014-02-01,1225101,352927,1578028
Brisbane,2014,3,2014-03-01,1392456,362753,1755209
Brisbane,2014,4,2014-04-01,1430220,406894,1837114
Brisbane,2014,5,2014-05-01,1377109,367449,1744558
Brisbane,2014,6,2014-06-01,1361433,393183,1754616
Brisbane,2014,7,2014-07-01,1524165,455749,1979914
Brisbane,2014,8,2014-08-01,1444799,436256,1881055
Brisbane,2014,9,2014-09-01,1447030,431100,1878130
Brisbane,2014,10,2014-10-01,1557772,438612,1996384
Brisbane,2014,11,2014-11-01,1389179,405203,1794382
Brisbane,2014,12,2014-12-01,1461391,473321,1934712
Brisbane,2015,1,2015-01-01,1320230,476635,1796865
Brisbane,2015,2,2015-02-01,1188499,390755,1579254
Brisbane,2015,3,2015-03-01,1389419,415222,1804641
Brisbane,2015,4,2015-04-01,1386700,418847,1805547
Brisbane,2015,5,2015-05-01,1333554,387506,1721060
Brisbane,2015,6,2015-06-01,1331860,414130,1745990
Brisbane,2015,7,2015-07-01,1528339,463080,1991419
Brisbane,2015,8,2015-08-01,1405051,450214,1855265
Brisbane,2015,9,2015-09-01,1458446,449229,1907675
Brisbane,2015,10,2015-10-01,1513535,458559,1972094
Brisbane,2015,11,2015-11-01,1443719,413350,1857069
Brisbane,2015,12,2015-12-01,1487622,500995,1988617
Brisbane,2016,1,2016-01-01,1352527,506456,1858983
Brisbane,2016,2,2016-02-01,1256169,408871,1665040
Brisbane,2016,3,2016-03-01,1427777,427516,1855293
Brisbane,2016,4,2016-04-01,1388552,419807,1808359
Brisbane,2016,5,2016-05-01,1364794,393626,1758420
Brisbane,2016,6,2016-06-01,1371519,430418,1801937
Brisbane,2016,7,2016-07-01,1534178,491367,2025545
Brisbane,2016,8,2016-08-01,1436244,460037,1896281
Brisbane,2016,9,2016-09-01,1489897,472962,1962859
Brisbane,2016,10,2016-10-01,1503029,483439,1986468
Brisbane,2016,11,2016-11-01,1437942,438687,1876629
Brisbane,2016,12,2016-12-01,1493224,516558,2009782
Brisbane,2017,1,2017-01-01,1379205,523794,1902999
Brisbane,2017,2,2017-02-01,1210431,412560,1622991
Brisbane,2017,3,2017-03-01,1405729,439977,1845706
Brisbane,2017,4,2017-04-01,1402313,476800,1879113
Brisbane,2017,5,2017-05-01,1373532,427029,1800561
Brisbane,2017,6,2017-06-01,1387399,456873,1844272
Brisbane,2017,7,2017-07-01,1563106,509949,2073055
Brisbane,2017,8,2017-08-01,1467515,483957,1951472
Brisbane,2017,9,2017-09-01,1494470,494152,1988622
Brisbane,2017,10,2017-10-01,1554142,494915,2049057
Brisbane,2017,11,2017-11-01,1480566,457800,1938366
Brisbane,2017,12,2017-12-01,1501518,551535,2053053
Brisbane,2018,1,2018-01-01,1378329,545045,1923374
Brisbane,2018,2,2018-02-01,1259538,443330,1702868
Brisbane,2018,3,2018-03-01,1457485,487297,1944782
Brisbane,2018,4,2018-04-01,1403739,490729,1894468
Brisbane,2018,5,2018-05-01,1409964,456579,1866543
Brisbane,2018,6,2018-06-01,1364609,487988,1852597
Brisbane,2018,7,2018-07-01,1596729,552620,2149349
Brisbane,2018,8,2018-08-01,1511547,534545,2046092
Brisbane,2018,9,2018-09-01,1454622,528778,1983400
Brisbane,2018,10,2018-10-01,1563298,532527,2095825
Brisbane,2018,11,2018-11-01,1490280,478663,1968943
Brisbane,2018,12,2018-12-01,1464389,574133,2038522
Brisbane,2019,1,2019-01-01,1374505,585934,1960439
Brisbane,2019,2,2019-02-01,1238654,459953,1698607
Cairns,2009,1,2009-01-01,268382,35521,303903
Cairns,2009,2,2009-02-01,209576,29586,239162
Cairns,2009,3,2009-03-01,237098,35737,272835
Cairns,2009,4,2009-04-01,255887,32110,287997
Cairns,2009,5,2009-05-01,241607,29334,270941
Cairns,2009,6,2009-06-01,247279,29244,276523
Cairns,2009,7,2009-07-01,308760,34132,342892
Cairns,2009,8,2009-08-01,290219,38767,328986
Cairns,2009,9,2009-09-01,276497,37523,314020
Cairns,2009,10,2009-10-01,290162,35753,325915
Cairns,2009,11,2009-11-01,261622,32700,294322
Cairns,2009,12,2009-12-01,246304,34396,280700
Cairns,2010,1,2010-01-01,237782,33779,271561
Cairns,2010,2,2010-02-01,222760,34452,257212
Cairns,2010,3,2010-03-01,232256,36760,269016
Cairns,2010,4,2010-04-01,249252,38048,287300
Cairns,2010,5,2010-05-01,238779,34653,273432
Cairns,2010,6,2010-06-01,268467,36417,304884
Cairns,2010,7,2010-07-01,320111,44887,364998
Cairns,2010,8,2010-08-01,303105,52202,355307
Cairns,2010,9,2010-09-01,301990,49347,351337
Cairns,2010,10,2010-10-01,317494,45249,362743
Cairns,2010,11,2010-11-01,277842,44313,322155
Cairns,2010,12,2010-12-01,284259,45766,330025
Cairns,2011,1,2011-01-01,264368,44157,308525
Cairns,2011,2,2011-02-01,217608,34887,252495
Cairns,2011,3,2011-03-01,242013,39153,281166
Cairns,2011,4,2011-04-01,272862,37378,310240
Cairns,2011,5,2011-05-01,261662,35860,297522
Cairns,2011,6,2011-06-01,285048,37778,322826
Cairns,2011,7,2011-07-01,337809,49108,386917
Cairns,2011,8,2011-08-01,316946,52806,369752
Cairns,2011,9,2011-09-01,296989,47790,344779
Cairns,2011,10,2011-10-01,311553,45291,356844
Cairns,2011,11,2011-11-01,277158,39153,316311
Cairns,2011,12,2011-12-01,277075,40711,317786
Cairns,2012,1,2012-01-01,283010,39833,322843
Cairns,2012,2,2012-02-01,224259,36582,260841
Cairns,2012,3,2012-03-01,256422,41270,297692
Cairns,2012,4,2012-04-01,287181,38120,325301
Cairns,2012,5,2012-05-01,271564,35313,306877
Cairns,2012,6,2012-06-01,298556,38223,336779
Cairns,2012,7,2012-07-01,354394,44560,398954
Cairns,2012,8,2012-08-01,329768,52894,382662
Cairns,2012,9,2012-09-01,316707,46996,363703
Cairns,2012,10,2012-10-01,343777,43540,387317
Cairns,2012,11,2012-11-01,309616,46171,355787
Cairns,2012,12,2012-12-01,293941,47857,341798
Cairns,2013,1,2013-01-01,292180,44563,336743
Cairns,2013,2,2013-02-01,252852,42018,294870
Cairns,2013,3,2013-03-01,262172,42723,304895
Cairns,2013,4,2013-04-01,295466,37759,333225
Cairns,2013,5,2013-05-01,271091,33343,304434
Cairns,2013,6,2013-06-01,318149,35315,353464
Cairns,2013,7,2013-07-01,378495,43559,422054
Cairns,2013,8,2013-08-01,357690,52260,409950
Cairns,2013,9,2013-09-01,340865,41475,382340
Cairns,2013,10,2013-10-01,354583,41073,395656
Cairns,2013,11,2013-11-01,306639,36018,342657
Cairns,2013,12,2013-12-01,324149,41985,366134
Cairns,2014,1,2014-01-01,333579,44132,377711
Cairns,2014,2,2014-02-01,261719,39246,300965
Cairns,2014,3,2014-03-01,272825,37857,310682
Cairns,2014,4,2014-04-01,311809,31064,342873
Cairns,2014,5,2014-05-01,281123,28967,310090
Cairns,2014,6,2014-06-01,303276,31948,335224
Cairns,2014,7,2014-07-01,384672,41712,426384
Cairns,2014,8,2014-08-01,359834,49468,409302
Cairns,2014,9,2014-09-01,342406,41330,383736
Cairns,2014,10,2014-10-01,359731,40304,400035
Cairns,2014,11,2014-11-01,313692,34165,347857
Cairns,2014,12,2014-12-01,332733,40717,373450
Cairns,2015,1,2015-01-01,317679,42956,360635
Cairns,2015,2,2015-02-01,284189,45036,329225
Cairns,2015,3,2015-03-01,282670,40675,323345
Cairns,2015,4,2015-04-01,315096,38315,353411
Cairns,2015,5,2015-05-01,290539,36765,327304
Cairns,2015,6,2015-06-01,319352,36936,356288
Cairns,2015,7,2015-07-01,390018,51488,441506
Cairns,2015,8,2015-08-01,370789,57648,428437
Cairns,2015,9,2015-09-01,351882,50042,401924
Cairns,2015,10,2015-10-01,365923,48686,414609
Cairns,2015,11,2015-11-01,332816,44903,377719
Cairns,2015,12,2015-12-01,354356,52283,406639
Cairns,2016,1,2016-01-01,346535,53954,400489
Cairns,2016,2,2016-02-01,298043,57828,355871
Cairns,2016,3,2016-03-01,319986,56245,376231
Cairns,2016,4,2016-04-01,322255,51843,374098
Cairns,2016,5,2016-05-01,307712,41758,349470
Cairns,2016,6,2016-06-01,340631,43345,383976
Cairns,2016,7,2016-07-01,414005,53824,467829
Cairns,2016,8,2016-08-01,384920,61624,446544
Cairns,2016,9,2016-09-01,374000,56817,430817
Cairns,2016,10,2016-10-01,387908,54613,442521
Cairns,2016,11,2016-11-01,346608,50685,397293
Cairns,2016,12,2016-12-01,365618,59757,425375
Cairns,2017,1,2017-01-01,369888,60832,430720
Cairns,2017,2,2017-02-01,279361,49084,328445
Cairns,2017,3,2017-03-01,317455,57820,375275
Cairns,2017,4,2017-04-01,362164,52499,414663
Cairns,2017,5,2017-05-01,313311,43926,357237
Cairns,2017,6,2017-06-01,334887,46583,381470
Cairns,2017,7,2017-07-01,422467,57449,479916
Cairns,2017,8,2017-08-01,387376,67500,454876
Cairns,2017,9,2017-09-01,374667,56520,431187
Cairns,2017,10,2017-10-01,398760,54809,453569
Cairns,2017,11,2017-11-01,351039,51381,402420
Cairns,2017,12,2017-12-01,366936,63770,430706
Cairns,2018,1,2018-01-01,363830,63479,427309
Cairns,2018,2,2018-02-01,301952,58428,360380
Cairns,2018,3,2018-03-01,327046,59383,386429
Cairns,2018,4,2018-04-01,346263,49989,396252
Cairns,2018,5,2018-05-01,321416,44000,365416
Cairns,2018,6,2018-06-01,335102,45459,380561
Cairns,2018,7,2018-07-01,424952,59433,484385
Cairns,2018,8,2018-08-01,400213,70165,470378
Cairns,2018,9,2018-09-01,368208,53562,421770
Cairns,2018,10,2018-10-01,394170,54570,448740
Cairns,2018,11,2018-11-01,342962,44856,387818
Cairns,2018,12,2018-12-01,357133,59227,416360
Cairns,2019,1,2019-01-01,348059,63585,411644
Cairns,2019,2,2019-02-01,281899,56610,338509
Canberra,2009,1,2009-01-01,209288,0,209288
Canberra,2009,2,2009-02-01,230217,0,230217
Canberra,2009,3,2009-03-01,280838,0,280838
Canberra,2009,4,2009-04-01,264465,0,264465
Canberra,2009,5,2009-05-01,266305,0,266305
Canberra,2009,6,2009-06-01,258763,0,258763
Canberra,2009,7,2009-07-01,270146,0,270146
Canberra,2009,8,2009-08-01,279935,0,279935
Canberra,2009,9,2009-09-01,278504,0,278504
Canberra,2009,10,2009-10-01,276057,0,276057
Canberra,2009,11,2009-11-01,276750,0,276750
Canberra,2009,12,2009-12-01,257152,0,257152
Canberra,2010,1,2010-01-01,223827,0,223827
Canberra,2010,2,2010-02-01,253453,0,253453
Canberra,2010,3,2010-03-01,317902,0,317902
Canberra,2010,4,2010-04-01,276640,0,276640
Canberra,2010,5,2010-05-01,271294,0,271294
Canberra,2010,6,2010-06-01,276736,0,276736
Canberra,2010,7,2010-07-01,280581,0,280581
Canberra,2010,8,2010-08-01,274884,0,274884
Canberra,2010,9,2010-09-01,280628,0,280628
Canberra,2010,10,2010-10-01,293946,0,293946
Canberra,2010,11,2010-11-01,290391,0,290391
Canberra,2010,12,2010-12-01,263728,0,263728
Canberra,2011,1,2011-01-01,215599,0,215599
Canberra,2011,2,2011-02-01,242060,0,242060
Canberra,2011,3,2011-03-01,295688,0,295688
Canberra,2011,4,2011-04-01,270185,0,270185
Canberra,2011,5,2011-05-01,276173,0,276173
Canberra,2011,6,2011-06-01,256985,0,256985
Canberra,2011,7,2011-07-01,280734,0,280734
Canberra,2011,8,2011-08-01,283048,0,283048
Canberra,2011,9,2011-09-01,284401,0,284401
Canberra,2011,10,2011-10-01,272400,0,272400
Canberra,2011,11,2011-11-01,278677,0,278677
Canberra,2011,12,2011-12-01,252275,0,252275
Canberra,2012,1,2012-01-01,208232,0,208232
Canberra,2012,2,2012-02-01,238261,0,238261
Canberra,2012,3,2012-03-01,285515,0,285515
Canberra,2012,4,2012-04-01,253993,0,253993
Canberra,2012,5,2012-05-01,269167,0,269167
Canberra,2012,6,2012-06-01,251982,0,251982
Canberra,2012,7,2012-07-01,259646,0,259646
Canberra,2012,8,2012-08-01,265390,0,265390
Canberra,2012,9,2012-09-01,259296,0,259296
Canberra,2012,10,2012-10-01,269446,0,269446
Canberra,2012,11,2012-11-01,270849,0,270849
Canberra,2012,12,2012-12-01,234116,0,234116
Canberra,2013,1,2013-01-01,197619,0,197619
Canberra,2013,2,2013-02-01,224695,0,224695
Canberra,2013,3,2013-03-01,271263,0,271263
Canberra,2013,4,2013-04-01,248936,0,248936
Canberra,2013,5,2013-05-01,260177,0,260177
Canberra,2013,6,2013-06-01,252527,0,252527
Canberra,2013,7,2013-07-01,255680,0,255680
Canberra,2013,8,2013-08-01,254173,0,254173
Canberra,2013,9,2013-09-01,242569,0,242569
Canberra,2013,10,2013-10-01,262734,0,262734
Canberra,2013,11,2013-11-01,256073,0,256073
Canberra,2013,12,2013-12-01,230002,0,230002
Canberra,2014,1,2014-01-01,187648,0,187648
Canberra,2014,2,2014-02-01,209224,0,209224
Canberra,2014,3,2014-03-01,250214,0,250214
Canberra,2014,4,2014-04-01,229234,0,229234
Canberra,2014,5,2014-05-01,244039,0,244039
Canberra,2014,6,2014-06-01,236028,0,236028
Canberra,2014,7,2014-07-01,244385,0,244385
Canberra,2014,8,2014-08-01,241562,0,241562
Canberra,2014,9,2014-09-01,243106,0,243106
Canberra,2014,10,2014-10-01,260678,0,260678
Canberra,2014,11,2014-11-01,242548,0,242548
Canberra,2014,12,2014-12-01,223156,0,223156
Canberra,2015,1,2015-01-01,181151,0,181151
Canberra,2015,2,2015-02-01,205201,0,205201
Canberra,2015,3,2015-03-01,251787,0,251787
Canberra,2015,4,2015-04-01,231630,0,231630
Canberra,2015,5,2015-05-01,242187,0,242187
Canberra,2015,6,2015-06-01,237400,0,237400
Canberra,2015,7,2015-07-01,247268,0,247268
Canberra,2015,8,2015-08-01,241653,0,241653
Canberra,2015,9,2015-09-01,243511,0,243511
Canberra,2015,10,2015-10-01,249665,0,249665
Canberra,2015,11,2015-11-01,250507,0,250507
Canberra,2015,12,2015-12-01,223346,0,223346
Canberra,2016,1,2016-01-01,181049,0,181049
Canberra,2016,2,2016-02-01,223470,0,223470
Canberra,2016,3,2016-03-01,252241,0,252241
Canberra,2016,4,2016-04-01,240418,0,240418
Canberra,2016,5,2016-05-01,242100,0,242100
Canberra,2016,6,2016-06-01,235758,0,235758
Canberra,2016,7,2016-07-01,246693,0,246693
Canberra,2016,8,2016-08-01,250702,0,250702
Canberra,2016,9,2016-09-01,252989,3205,256194
Canberra,2016,10,2016-10-01,256566,6995,263561
Canberra,2016,11,2016-11-01,265734,6667,272401
Canberra,2016,12,2016-12-01,238073,6904,244977
Canberra,2017,1,2017-01-01,191726,8068,199794
Canberra,2017,2,2017-02-01,225451,5907,231358
Canberra,2017,3,2017-03-01,273652,6509,280161
Canberra,2017,4,2017-04-01,237379,7388,244767
Canberra,2017,5,2017-05-01,258539,5531,264070
Canberra,2017,6,2017-06-01,251985,6758,258743
Canberra,2017,7,2017-07-01,258987,6887,265874
Canberra,2017,8,2017-08-01,262384,6553,268937
Canberra,2017,9,2017-09-01,267430,7274,274704
Canberra,2017,10,2017-10-01,272010,7556,279566
Canberra,2017,11,2017-11-01,276338,7163,283501
Canberra,2017,12,2017-12-01,245459,8841,254300
Canberra,2018,1,2018-01-01,199095,8992,208087
Canberra,2018,2,2018-02-01,234413,7015,241428
Canberra,2018,3,2018-03-01,282710,7712,290422
Canberra,2018,4,2018-04-01,257254,9576,266830
Canberra,2018,5,2018-05-01,272724,7155,279879
Canberra,2018,6,2018-06-01,256986,8195,265181
Canberra,2018,7,2018-07-01,280265,8782,289047
Canberra,2018,8,2018-08-01,282451,7838,290289
Canberra,2018,9,2018-09-01,270166,8468,278634
Canberra,2018,10,2018-10-01,292060,7283,299343
Canberra,2018,11,2018-11-01,286692,7027,293719
Canberra,2018,12,2018-12-01,238327,6879,245206
Canberra,2019,1,2019-01-01,201548,6735,208283
Canberra,2019,2,2019-02-01,239012,5517,244529
Darwin,2009,1,2009-01-01,91425,16729,108154
Darwin,2009,2,2009-02-01,74666,10820,85486
Darwin,2009,3,2009-03-01,88028,10389,98417
Darwin,2009,4,2009-04-01,107091,14829,121920
Darwin,2009,5,2009-05-01,118392,16907,135299
Darwin,2009,6,2009-06-01,131354,18426,149780
Darwin,2009,7,2009-07-01,145239,19498,164737
Darwin,2009,8,2009-08-01,134606,19118,153724
Darwin,2009,9,2009-09-01,124713,18153,142866
Darwin,2009,10,2009-10-01,116651,17432,134083
Darwin,2009,11,2009-11-01,95702,15676,111378
Darwin,2009,12,2009-12-01,96932,17765,114697
Darwin,2010,1,2010-01-01,93253,19459,112712
Darwin,2010,2,2010-02-01,81646,13617,95263
Darwin,2010,3,2010-03-01,102497,14071,116568
Darwin,2010,4,2010-04-01,109284,16789,126073
Darwin,2010,5,2010-05-01,116949,17162,134111
Darwin,2010,6,2010-06-01,131301,19085,150386
Darwin,2010,7,2010-07-01,155019,22668,177687
Darwin,2010,8,2010-08-01,143066,20447,163513
Darwin,2010,9,2010-09-01,135942,19712,155654
Darwin,2010,10,2010-10-01,126041,18274,144315
Darwin,2010,11,2010-11-01,102324,15972,118296
Darwin,2010,12,2010-12-01,108646,19749,128395
Darwin,2011,1,2011-01-01,102790,25487,128277
Darwin,2011,2,2011-02-01,77120,18478,95598
Darwin,2011,3,2011-03-01,99957,20464,120421
Darwin,2011,4,2011-04-01,115129,23492,138621
Darwin,2011,5,2011-05-01,118712,23106,141818
Darwin,2011,6,2011-06-01,128718,24365,153083
Darwin,2011,7,2011-07-01,186513,34179,220692
Darwin,2011,8,2011-08-01,165978,30719,196697
Darwin,2011,9,2011-09-01,149596,30810,180406
Darwin,2011,10,2011-10-01,150285,32389,182674
Darwin,2011,11,2011-11-01,131857,31154,163011
Darwin,2011,12,2011-12-01,133115,32292,165407
Darwin,2012,1,2012-01-01,126246,33868,160114
Darwin,2012,2,2012-02-01,107527,25784,133311
Darwin,2012,3,2012-03-01,123254,25947,149201
Darwin,2012,4,2012-04-01,130492,27148,157640
Darwin,2012,5,2012-05-01,133399,24420,157819
Darwin,2012,6,2012-06-01,149150,28500,177650
Darwin,2012,7,2012-07-01,171855,33129,204984
Darwin,2012,8,2012-08-01,156107,27555,183662
Darwin,2012,9,2012-09-01,140815,25226,166041
Darwin,2012,10,2012-10-01,133643,27156,160799
Darwin,2012,11,2012-11-01,119955,23677,143632
Darwin,2012,12,2012-12-01,119635,26304,145939
Darwin,2013,1,2013-01-01,116512,27993,144505
Darwin,2013,2,2013-02-01,94610,21485,116095
Darwin,2013,3,2013-03-01,123576,24404,147980
Darwin,2013,4,2013-04-01,133559,26240,159799
Darwin,2013,5,2013-05-01,132059,24140,156199
Darwin,2013,6,2013-06-01,147195,25723,172918
Darwin,2013,7,2013-07-01,172526,33603,206129
Darwin,2013,8,2013-08-01,161291,30753,192044
Darwin,2013,9,2013-09-01,149500,30122,179622
Darwin,2013,10,2013-10-01,156043,30106,186149
Darwin,2013,11,2013-11-01,125513,26735,152248
Darwin,2013,12,2013-12-01,131547,31913,163460
Darwin,2014,1,2014-01-01,124658,34667,159325
Darwin,2014,2,2014-02-01,102892,23155,126047
Darwin,2014,3,2014-03-01,121522,24208,145730
Darwin,2014,4,2014-04-01,144484,22854,167338
Darwin,2014,5,2014-05-01,144204,23146,167350
Darwin,2014,6,2014-06-01,171576,27564,199140
Darwin,2014,7,2014-07-01,189095,31135,220230
Darwin,2014,8,2014-08-01,176291,30346,206637
Darwin,2014,9,2014-09-01,158085,27740,185825
Darwin,2014,10,2014-10-01,158301,27254,185555
Darwin,2014,11,2014-11-01,132242,21821,154063
Darwin,2014,12,2014-12-01,137189,24780,161969
Darwin,2015,1,2015-01-01,124377,25729,150106
Darwin,2015,2,2015-02-01,102522,18791,121313
Darwin,2015,3,2015-03-01,125996,20094,146090
Darwin,2015,4,2015-04-01,144072,20018,164090
Darwin,2015,5,2015-05-01,147394,21442,168836
Darwin,2015,6,2015-06-01,169595,23068,192663
Darwin,2015,7,2015-07-01,195605,27240,222845
Darwin,2015,8,2015-08-01,175176,23499,198675
Darwin,2015,9,2015-09-01,162476,21279,183755
Darwin,2015,10,2015-10-01,154078,20791,174869
Darwin,2015,11,2015-11-01,133274,18641,151915
Darwin,2015,12,2015-12-01,134196,22195,156391
Darwin,2016,1,2016-01-01,124718,24712,149430
Darwin,2016,2,2016-02-01,106536,16718,123254
Darwin,2016,3,2016-03-01,130515,17924,148439
Darwin,2016,4,2016-04-01,142935,19829,162764
Darwin,2016,5,2016-05-01,150562,21756,172318
Darwin,2016,6,2016-06-01,172733,23883,196616
Darwin,2016,7,2016-07-01,193370,29485,222855
Darwin,2016,8,2016-08-01,177543,25325,202868
Darwin,2016,9,2016-09-01,163210,23857,187067
Darwin,2016,10,2016-10-01,164121,23383,187504
Darwin,2016,11,2016-11-01,137105,19197,156302
Darwin,2016,12,2016-12-01,139781,26000,165781
Darwin,2017,1,2017-01-01,133006,28976,161982
Darwin,2017,2,2017-02-01,106758,18771,125529
Darwin,2017,3,2017-03-01,130465,19414,149879
Darwin,2017,4,2017-04-01,145541,23067,168608
Darwin,2017,5,2017-05-01,146897,21133,168030
Darwin,2017,6,2017-06-01,170807,25528,196335
Darwin,2017,7,2017-07-01,194184,27915,222099
Darwin,2017,8,2017-08-01,181932,24195,206127
Darwin,2017,9,2017-09-01,159949,22176,182125
Darwin,2017,10,2017-10-01,158995,21895,180890
Darwin,2017,11,2017-11-01,136257,19108,155365
Darwin,2017,12,2017-12-01,137207,22679,159886
Darwin,2018,1,2018-01-01,129687,25929,155616
Darwin,2018,2,2018-02-01,103333,16283,119616
Darwin,2018,3,2018-03-01,127354,15824,143178
Darwin,2018,4,2018-04-01,140267,18107,158374
Darwin,2018,5,2018-05-01,147236,16163,163399
Darwin,2018,6,2018-06-01,162414,20907,183321
Darwin,2018,7,2018-07-01,193951,20395,214346
Darwin,2018,8,2018-08-01,174835,20540,195375
Darwin,2018,9,2018-09-01,160451,18338,178789
Darwin,2018,10,2018-10-01,152320,17961,170281
Darwin,2018,11,2018-11-01,124123,17044,141167
Darwin,2018,12,2018-12-01,127821,21100,148921
Darwin,2019,1,2019-01-01,118878,23381,142259
Darwin,2019,2,2019-02-01,101357,15890,117247
Gold Coast,2009,1,2009-01-01,394783,51520,446303
Gold Coast,2009,2,2009-02-01,310807,43252,354059
Gold Coast,2009,3,2009-03-01,352490,48055,400545
Gold Coast,2009,4,2009-04-01,353443,45251,398694
Gold Coast,2009,5,2009-05-01,331644,49313,380957
Gold Coast,2009,6,2009-06-01,309837,42403,352240
Gold Coast,2009,7,2009-07-01,364120,48278,412398
Gold Coast,2009,8,2009-08-01,356277,56531,412808
Gold Coast,2009,9,2009-09-01,371060,61889,432949
Gold Coast,2009,10,2009-10-01,391315,61650,452965
Gold Coast,2009,11,2009-11-01,357607,62272,419879
Gold Coast,2009,12,2009-12-01,353053,65918,418971
Gold Coast,2010,1,2010-01-01,395052,68818,463870
Gold Coast,2010,2,2010-02-01,361539,62510,424049
Gold Coast,2010,3,2010-03-01,393163,71368,464531
Gold Coast,2010,4,2010-04-01,390742,60743,451485
Gold Coast,2010,5,2010-05-01,363421,54366,417787
Gold Coast,2010,6,2010-06-01,358864,55591,414455
Gold Coast,2010,7,2010-07-01,418900,63956,482856
Gold Coast,2010,8,2010-08-01,389109,71713,460822
Gold Coast,2010,9,2010-09-01,412866,68283,481149
Gold Coast,2010,10,2010-10-01,420873,66990,487863
Gold Coast,2010,11,2010-11-01,404937,66063,471000
Gold Coast,2010,12,2010-12-01,420485,76268,496753
Gold Coast,2011,1,2011-01-01,482289,79326,561615
Gold Coast,2011,2,2011-02-01,341385,64068,405453
Gold Coast,2011,3,2011-03-01,373225,62786,436011
Gold Coast,2011,4,2011-04-01,379626,53911,433537
Gold Coast,2011,5,2011-05-01,344397,53751,398148
Gold Coast,2011,6,2011-06-01,326280,44585,370865
Gold Coast,2011,7,2011-07-01,391092,53214,444306
Gold Coast,2011,8,2011-08-01,360019,62176,422195
Gold Coast,2011,9,2011-09-01,379789,53780,433569
Gold Coast,2011,10,2011-10-01,407864,59831,467695
Gold Coast,2011,11,2011-11-01,385568,58878,444446
Gold Coast,2011,12,2011-12-01,409766,69557,479323
Gold Coast,2012,1,2012-01-01,443910,72172,516082
Gold Coast,2012,2,2012-02-01,357671,61063,418734
Gold Coast,2012,3,2012-03-01,393185,64068,457253
Gold Coast,2012,4,2012-04-01,392289,58857,451146
Gold Coast,2012,5,2012-05-01,337799,49232,387031
Gold Coast,2012,6,2012-06-01,342614,62176,404790
Gold Coast,2012,7,2012-07-01,409914,75272,485186
Gold Coast,2012,8,2012-08-01,389023,73056,462079
Gold Coast,2012,9,2012-09-01,443540,71284,514824
Gold Coast,2012,10,2012-10-01,462845,75623,538468
Gold Coast,2012,11,2012-11-01,429324,72129,501453
Gold Coast,2012,12,2012-12-01,452771,89492,542263
Gold Coast,2013,1,2013-01-01,465651,88233,553884
Gold Coast,2013,2,2013-02-01,357805,70389,428194
Gold Coast,2013,3,2013-03-01,399646,77248,476894
Gold Coast,2013,4,2013-04-01,413422,65807,479229
Gold Coast,2013,5,2013-05-01,343045,60981,404026
Gold Coast,2013,6,2013-06-01,355424,63022,418446
Gold Coast,2013,7,2013-07-01,425469,70657,496126
Gold Coast,2013,8,2013-08-01,397035,71713,468748
Gold Coast,2013,9,2013-09-01,429212,68346,497558
Gold Coast,2013,10,2013-10-01,467056,72377,539433
Gold Coast,2013,11,2013-11-01,399136,68134,467270
Gold Coast,2013,12,2013-12-01,449305,87998,537303
Gold Coast,2014,1,2014-01-01,482165,93012,575177
Gold Coast,2014,2,2014-02-01,356191,73294,429485
Gold Coast,2014,3,2014-03-01,395498,75397,470895
Gold Coast,2014,4,2014-04-01,401760,68566,470326
Gold Coast,2014,5,2014-05-01,354168,60389,414557
Gold Coast,2014,6,2014-06-01,351232,65427,416659
Gold Coast,2014,7,2014-07-01,428940,77142,506082
Gold Coast,2014,8,2014-08-01,403253,72577,475830
Gold Coast,2014,9,2014-09-01,428273,69155,497428
Gold Coast,2014,10,2014-10-01,475540,72469,548009
Gold Coast,2014,11,2014-11-01,412304,69284,481588
Gold Coast,2014,12,2014-12-01,458529,84259,542788
Gold Coast,2015,1,2015-01-01,476215,87907,564122
Gold Coast,2015,2,2015-02-01,356609,68048,424657
Gold Coast,2015,3,2015-03-01,399943,72862,472805
Gold Coast,2015,4,2015-04-01,416149,71270,487419
Gold Coast,2015,5,2015-05-01,366812,65763,432575
Gold Coast,2015,6,2015-06-01,365899,68221,434120
Gold Coast,2015,7,2015-07-01,451304,89818,541122
Gold Coast,2015,8,2015-08-01,412432,75230,487662
Gold Coast,2015,9,2015-09-01,454749,82921,537670
Gold Coast,2015,10,2015-10-01,478036,86057,564093
Gold Coast,2015,11,2015-11-01,430836,78158,508994
Gold Coast,2015,12,2015-12-01,472407,96712,569119
Gold Coast,2016,1,2016-01-01,516187,96249,612436
Gold Coast,2016,2,2016-02-01,399958,79077,479035
Gold Coast,2016,3,2016-03-01,437430,90673,528103
Gold Coast,2016,4,2016-04-01,432475,85440,517915
Gold Coast,2016,5,2016-05-01,383974,78071,462045
Gold Coast,2016,6,2016-06-01,381415,83797,465212
Gold Coast,2016,7,2016-07-01,468577,106980,575557
Gold Coast,2016,8,2016-08-01,425852,96204,522056
Gold Coast,2016,9,2016-09-01,461229,96880,558109
Gold Coast,2016,10,2016-10-01,488023,92944,580967
Gold Coast,2016,11,2016-11-01,439507,84659,524166
Gold Coast,2016,12,2016-12-01,483130,102584,585714
Gold Coast,2017,1,2017-01-01,519274,103891,623165
Gold Coast,2017,2,2017-02-01,387530,79072,466602
Gold Coast,2017,3,2017-03-01,427526,87140,514666
Gold Coast,2017,4,2017-04-01,463896,94224,558120
Gold Coast,2017,5,2017-05-01,396610,78638,475248
Gold Coast,2017,6,2017-06-01,391035,81771,472806
Gold Coast,2017,7,2017-07-01,479160,96073,575233
Gold Coast,2017,8,2017-08-01,424804,90270,515074
Gold Coast,2017,9,2017-09-01,459920,87763,547683
Gold Coast,2017,10,2017-10-01,492906,94235,587141
Gold Coast,2017,11,2017-11-01,454388,84533,538921
Gold Coast,2017,12,2017-12-01,501936,102488,604424
Gold Coast,2018,1,2018-01-01,546266,103065,649331
Gold Coast,2018,2,2018-02-01,399352,78215,477567
Gold Coast,2018,3,2018-03-01,451445,88293,539738
Gold Coast,2018,4,2018-04-01,477466,90335,567801
Gold Coast,2018,5,2018-05-01,392798,74786,467584
Gold Coast,2018,6,2018-06-01,390559,80355,470914
Gold Coast,2018,7,2018-07-01,477736,93621,571357
Gold Coast,2018,8,2018-08-01,447670,85896,533566
Gold Coast,2018,9,2018-09-01,456554,79182,535736
Gold Coast,2018,10,2018-10-01,487025,86575,573600
Gold Coast,2018,11,2018-11-01,446924,73826,520750
Gold Coast,2018,12,2018-12-01,487389,91049,578438
Gold Coast,2019,1,2019-01-01,542174,95623,637797
Gold Coast,2019,2,2019-02-01,388248,70223,458471
Hobart,2009,1,2009-01-01,184809,0,184809
Hobart,2009,2,2009-02-01,158193,0,158193
Hobart,2009,3,2009-03-01,173896,0,173896
Hobart,2009,4,2009-04-01,162306,0,162306
Hobart,2009,5,2009-05-01,148346,0,148346
Hobart,2009,6,2009-06-01,132300,0,132300
Hobart,2009,7,2009-07-01,139697,0,139697
Hobart,2009,8,2009-08-01,146013,0,146013
Hobart,2009,9,2009-09-01,150711,0,150711
Hobart,2009,10,2009-10-01,157938,0,157938
Hobart,2009,11,2009-11-01,156326,0,156326
Hobart,2009,12,2009-12-01,163924,0,163924
Hobart,2010,1,2010-01-01,172077,0,172077
Hobart,2010,2,2010-02-01,157593,0,157593
Hobart,2010,3,2010-03-01,167728,0,167728
Hobart,2010,4,2010-04-01,159126,0,159126
Hobart,2010,5,2010-05-01,147065,0,147065
Hobart,2010,6,2010-06-01,137673,0,137673
Hobart,2010,7,2010-07-01,144598,0,144598
Hobart,2010,8,2010-08-01,143960,0,143960
Hobart,2010,9,2010-09-01,151459,0,151459
Hobart,2010,10,2010-10-01,156173,0,156173
Hobart,2010,11,2010-11-01,161287,0,161287
Hobart,2010,12,2010-12-01,183353,0,183353
Hobart,2011,1,2011-01-01,199384,0,199384
Hobart,2011,2,2011-02-01,162913,0,162913
Hobart,2011,3,2011-03-01,177930,0,177930
Hobart,2011,4,2011-04-01,156455,0,156455
Hobart,2011,5,2011-05-01,145879,0,145879
Hobart,2011,6,2011-06-01,119774,0,119774
Hobart,2011,7,2011-07-01,135786,0,135786
Hobart,2011,8,2011-08-01,135050,0,135050
Hobart,2011,9,2011-09-01,140928,0,140928
Hobart,2011,10,2011-10-01,150448,0,150448
Hobart,2011,11,2011-11-01,153076,0,153076
Hobart,2011,12,2011-12-01,167058,0,167058
Hobart,2012,1,2012-01-01,182301,0,182301
Hobart,2012,2,2012-02-01,155295,0,155295
Hobart,2012,3,2012-03-01,166159,0,166159
Hobart,2012,4,2012-04-01,153958,0,153958
Hobart,2012,5,2012-05-01,139870,0,139870
Hobart,2012,6,2012-06-01,134708,0,134708
Hobart,2012,7,2012-07-01,140625,0,140625
Hobart,2012,8,2012-08-01,140216,0,140216
Hobart,2012,9,2012-09-01,156108,0,156108
Hobart,2012,10,2012-10-01,166109,0,166109
Hobart,2012,11,2012-11-01,182513,0,182513
Hobart,2012,12,2012-12-01,201164,0,201164
Hobart,2013,1,2013-01-01,207905,0,207905
Hobart,2013,2,2013-02-01,169053,0,169053
Hobart,2013,3,2013-03-01,191793,0,191793
Hobart,2013,4,2013-04-01,178356,0,178356
Hobart,2013,5,2013-05-01,150016,0,150016
Hobart,2013,6,2013-06-01,142693,0,142693
Hobart,2013,7,2013-07-01,164872,0,164872
Hobart,2013,8,2013-08-01,159649,0,159649
Hobart,2013,9,2013-09-01,160641,0,160641
Hobart,2013,10,2013-10-01,180907,0,180907
Hobart,2013,11,2013-11-01,181507,0,181507
Hobart,2013,12,2013-12-01,204314,0,204314
Hobart,2014,1,2014-01-01,212436,0,212436
Hobart,2014,2,2014-02-01,171232,0,171232
Hobart,2014,3,2014-03-01,192294,0,192294
Hobart,2014,4,2014-04-01,174940,0,174940
Hobart,2014,5,2014-05-01,153354,0,153354
Hobart,2014,6,2014-06-01,150496,0,150496
Hobart,2014,7,2014-07-01,167840,0,167840
Hobart,2014,8,2014-08-01,158639,0,158639
Hobart,2014,9,2014-09-01,160176,0,160176
Hobart,2014,10,2014-10-01,186458,0,186458
Hobart,2014,11,2014-11-01,188538,0,188538
Hobart,2014,12,2014-12-01,211578,0,211578
Hobart,2015,1,2015-01-01,225755,0,225755
Hobart,2015,2,2015-02-01,186006,0,186006
Hobart,2015,3,2015-03-01,199193,0,199193
Hobart,2015,4,2015-04-01,183667,0,183667
Hobart,2015,5,2015-05-01,162490,0,162490
Hobart,2015,6,2015-06-01,156018,0,156018
Hobart,2015,7,2015-07-01,173315,0,173315
Hobart,2015,8,2015-08-01,161551,0,161551
Hobart,2015,9,2015-09-01,170156,0,170156
Hobart,2015,10,2015-10-01,193735,0,193735
Hobart,2015,11,2015-11-01,199596,0,199596
Hobart,2015,12,2015-12-01,226950,0,226950
Hobart,2016,1,2016-01-01,232476,0,232476
Hobart,2016,2,2016-02-01,195914,0,195914
Hobart,2016,3,2016-03-01,212047,0,212047
Hobart,2016,4,2016-04-01,197064,0,197064
Hobart,2016,5,2016-05-01,176551,0,176551
Hobart,2016,6,2016-06-01,173584,0,173584
Hobart,2016,7,2016-07-01,183639,0,183639
Hobart,2016,8,2016-08-01,168478,0,168478
Hobart,2016,9,2016-09-01,185094,0,185094
Hobart,2016,10,2016-10-01,205417,0,205417
Hobart,2016,11,2016-11-01,207040,0,207040
Hobart,2016,12,2016-12-01,240833,0,240833
Hobart,2017,1,2017-01-01,250267,0,250267
Hobart,2017,2,2017-02-01,205384,0,205384
Hobart,2017,3,2017-03-01,219238,0,219238
Hobart,2017,4,2017-04-01,214518,0,214518
Hobart,2017,5,2017-05-01,180575,0,180575
Hobart,2017,6,2017-06-01,180309,0,180309
Hobart,2017,7,2017-07-01,201627,0,201627
Hobart,2017,8,2017-08-01,175246,0,175246
Hobart,2017,9,2017-09-01,189460,0,189460
Hobart,2017,10,2017-10-01,217102,0,217102
Hobart,2017,11,2017-11-01,221112,0,221112
Hobart,2017,12,2017-12-01,255505,0,255505
Hobart,2018,1,2018-01-01,266584,0,266584
Hobart,2018,2,2018-02-01,223015,0,223015
Hobart,2018,3,2018-03-01,248498,0,248498
Hobart,2018,4,2018-04-01,229894,0,229894
Hobart,2018,5,2018-05-01,183573,0,183573
Hobart,2018,6,2018-06-01,184480,0,184480
Hobart,2018,7,2018-07-01,212892,0,212892
Hobart,2018,8,2018-08-01,188905,0,188905
Hobart,2018,9,2018-09-01,198692,0,198692
Hobart,2018,10,2018-10-01,235768,0,235768
Hobart,2018,11,2018-11-01,237664,0,237664
Hobart,2018,12,2018-12-01,266663,0,266663
Hobart,2019,1,2019-01-01,278206,0,278206
Hobart,2019,2,2019-02-01,231911,0,231911
Karratha,2009,1,2009-01-01,35212,0,35212
Karratha,2009,2,2009-02-01,36709,0,36709
Karratha,2009,3,2009-03-01,41000,0,41000
Karratha,2009,4,2009-04-01,43365,0,43365
Karratha,2009,5,2009-05-01,44128,0,44128
Karratha,2009,6,2009-06-01,44778,0,44778
Karratha,2009,7,2009-07-01,48262,0,48262
Karratha,2009,8,2009-08-01,47285,0,47285
Karratha,2009,9,2009-09-01,50460,0,50460
Karratha,2009,10,2009-10-01,51650,0,51650
Karratha,2009,11,2009-11-01,50290,0,50290
Karratha,2009,12,2009-12-01,46030,0,46030
Karratha,2010,1,2010-01-01,44123,0,44123
Karratha,2010,2,2010-02-01,44658,0,44658
Karratha,2010,3,2010-03-01,53579,0,53579
Karratha,2010,4,2010-04-01,49547,0,49547
Karratha,2010,5,2010-05-01,50107,0,50107
Karratha,2010,6,2010-06-01,51220,0,51220
Karratha,2010,7,2010-07-01,55652,0,55652
Karratha,2010,8,2010-08-01,54083,0,54083
Karratha,2010,9,2010-09-01,55690,0,55690
Karratha,2010,10,2010-10-01,58726,0,58726
Karratha,2010,11,2010-11-01,57787,0,57787
Karratha,2010,12,2010-12-01,53635,0,53635
Karratha,2011,1,2011-01-01,50603,0,50603
Karratha,2011,2,2011-02-01,50071,0,50071
Karratha,2011,3,2011-03-01,60875,0,60875
Karratha,2011,4,2011-04-01,57365,0,57365
Karratha,2011,5,2011-05-01,61690,0,61690
Karratha,2011,6,2011-06-01,59030,0,59030
Karratha,2011,7,2011-07-01,67620,0,67620
Karratha,2011,8,2011-08-01,69045,0,69045
Karratha,2011,9,2011-09-01,66852,0,66852
Karratha,2011,10,2011-10-01,65088,0,65088
Karratha,2011,11,2011-11-01,70204,0,70204
Karratha,2011,12,2011-12-01,61868,0,61868
Karratha,2012,1,2012-01-01,61735,0,61735
Karratha,2012,2,2012-02-01,64623,0,64623
Karratha,2012,3,2012-03-01,67709,0,67709
Karratha,2012,4,2012-04-01,65109,0,65109
Karratha,2012,5,2012-05-01,71426,0,71426
Karratha,2012,6,2012-06-01,67022,0,67022
Karratha,2012,7,2012-07-01,72519,0,72519
Karratha,2012,8,2012-08-01,72732,0,72732
Karratha,2012,9,2012-09-01,67583,0,67583
Karratha,2012,10,2012-10-01,75322,0,75322
Karratha,2012,11,2012-11-01,71534,0,71534
Karratha,2012,12,2012-12-01,61101,0,61101
Karratha,2013,1,2013-01-01,64572,0,64572
Karratha,2013,2,2013-02-01,56830,0,56830
Karratha,2013,3,2013-03-01,67750,0,67750
Karratha,2013,4,2013-04-01,69585,0,69585
Karratha,2013,5,2013-05-01,71991,0,71991
Karratha,2013,6,2013-06-01,64005,0,64005
Karratha,2013,7,2013-07-01,70376,0,70376
Karratha,2013,8,2013-08-01,63514,0,63514
Karratha,2013,9,2013-09-01,60801,0,60801
Karratha,2013,10,2013-10-01,66135,0,66135
Karratha,2013,11,2013-11-01,60159,0,60159
Karratha,2013,12,2013-12-01,54897,0,54897
Karratha,2014,1,2014-01-01,58369,0,58369
Karratha,2014,2,2014-02-01,55555,0,55555
Karratha,2014,3,2014-03-01,59034,0,59034
Karratha,2014,4,2014-04-01,60206,0,60206
Karratha,2014,5,2014-05-01,61659,0,61659
Karratha,2014,6,2014-06-01,57093,0,57093
Karratha,2014,7,2014-07-01,62633,0,62633
Karratha,2014,8,2014-08-01,60761,0,60761
Karratha,2014,9,2014-09-01,60430,0,60430
Karratha,2014,10,2014-10-01,64776,0,64776
Karratha,2014,11,2014-11-01,57388,0,57388
Karratha,2014,12,2014-12-01,52464,0,52464
Karratha,2015,1,2015-01-01,49166,0,49166
Karratha,2015,2,2015-02-01,48714,0,48714
Karratha,2015,3,2015-03-01,51828,0,51828
Karratha,2015,4,2015-04-01,52583,0,52583
Karratha,2015,5,2015-05-01,50202,0,50202
Karratha,2015,6,2015-06-01,49995,0,49995
Karratha,2015,7,2015-07-01,55213,0,55213
Karratha,2015,8,2015-08-01,50149,0,50149
Karratha,2015,9,2015-09-01,51820,0,51820
Karratha,2015,10,2015-10-01,52010,0,52010
Karratha,2015,11,2015-11-01,50117,0,50117
Karratha,2015,12,2015-12-01,45789,0,45789
Karratha,2016,1,2016-01-01,40139,0,40139
Karratha,2016,2,2016-02-01,39180,0,39180
Karratha,2016,3,2016-03-01,42765,0,42765
Karratha,2016,4,2016-04-01,41920,0,41920
Karratha,2016,5,2016-05-01,46283,0,46283
Karratha,2016,6,2016-06-01,41394,0,41394
Karratha,2016,7,2016-07-01,41239,0,41239
Karratha,2016,8,2016-08-01,41920,0,41920
Karratha,2016,9,2016-09-01,41591,0,41591
Karratha,2016,10,2016-10-01,41162,0,41162
Karratha,2016,11,2016-11-01,42004,0,42004
Karratha,2016,12,2016-12-01,35297,0,35297
Karratha,2017,1,2017-01-01,34832,0,34832
Karratha,2017,2,2017-02-01,33327,0,33327
Karratha,2017,3,2017-03-01,38957,0,38957
Karratha,2017,4,2017-04-01,35587,0,35587
Karratha,2017,5,2017-05-01,39687,0,39687
Karratha,2017,6,2017-06-01,38363,0,38363
Karratha,2017,7,2017-07-01,36530,0,36530
Karratha,2017,8,2017-08-01,37596,0,37596
Karratha,2017,9,2017-09-01,35285,0,35285
Karratha,2017,10,2017-10-01,38147,0,38147
Karratha,2017,11,2017-11-01,37531,0,37531
Karratha,2017,12,2017-12-01,33205,0,33205
Karratha,2018,1,2018-01-01,33500,0,33500
Karratha,2018,2,2018-02-01,32428,0,32428
Karratha,2018,3,2018-03-01,36553,0,36553
Karratha,2018,4,2018-04-01,35954,0,35954
Karratha,2018,5,2018-05-01,39248,0,39248
Karratha,2018,6,2018-06-01,36919,0,36919
Karratha,2018,7,2018-07-01,40136,0,40136
Karratha,2018,8,2018-08-01,40180,0,40180
Karratha,2018,9,2018-09-01,36730,0,36730
Karratha,2018,10,2018-10-01,39582,0,39582
Karratha,2018,11,2018-11-01,37977,0,37977
Karratha,2018,12,2018-12-01,32242,0,32242
Karratha,2019,1,2019-01-01,35731,0,35731
Karratha,2019,2,2019-02-01,33811,0,33811
Launceston,2009,1,2009-01-01,110202,0,110202
Launceston,2009,2,2009-02-01,93002,0,93002
Launceston,2009,3,2009-03-01,105197,0,105197
Launceston,2009,4,2009-04-01,97161,0,97161
Launceston,2009,5,2009-05-01,89835,0,89835
Launceston,2009,6,2009-06-01,84736,0,84736
Launceston,2009,7,2009-07-01,88014,0,88014
Launceston,2009,8,2009-08-01,89019,0,89019
Launceston,2009,9,2009-09-01,91210,0,91210
Launceston,2009,10,2009-10-01,94200,0,94200
Launceston,2009,11,2009-11-01,94892,0,94892
Launceston,2009,12,2009-12-01,98906,0,98906
Launceston,2010,1,2010-01-01,106007,0,106007
Launceston,2010,2,2010-02-01,94505,0,94505
Launceston,2010,3,2010-03-01,100781,0,100781
Launceston,2010,4,2010-04-01,100119,0,100119
Launceston,2010,5,2010-05-01,88629,0,88629
Launceston,2010,6,2010-06-01,85044,0,85044
Launceston,2010,7,2010-07-01,89194,0,89194
Launceston,2010,8,2010-08-01,88937,0,88937
Launceston,2010,9,2010-09-01,91913,0,91913
Launceston,2010,10,2010-10-01,97389,0,97389
Launceston,2010,11,2010-11-01,97383,0,97383
Launceston,2010,12,2010-12-01,118066,0,118066
Launceston,2011,1,2011-01-01,115583,0,115583
Launceston,2011,2,2011-02-01,95134,0,95134
Launceston,2011,3,2011-03-01,106731,0,106731
Launceston,2011,4,2011-04-01,96532,0,96532
Launceston,2011,5,2011-05-01,85979,0,85979
Launceston,2011,6,2011-06-01,73515,0,73515
Launceston,2011,7,2011-07-01,84628,0,84628
Launceston,2011,8,2011-08-01,85162,0,85162
Launceston,2011,9,2011-09-01,86978,0,86978
Launceston,2011,10,2011-10-01,91265,0,91265
Launceston,2011,11,2011-11-01,96466,0,96466
Launceston,2011,12,2011-12-01,107641,0,107641
Launceston,2012,1,2012-01-01,113789,0,113789
Launceston,2012,2,2012-02-01,93314,0,93314
Launceston,2012,3,2012-03-01,101345,0,101345
Launceston,2012,4,2012-04-01,97383,0,97383
Launceston,2012,5,2012-05-01,87178,0,87178
Launceston,2012,6,2012-06-01,85027,0,85027
Launceston,2012,7,2012-07-01,83773,0,83773
Launceston,2012,8,2012-08-01,88289,0,88289
Launceston,2012,9,2012-09-01,97098,0,97098
Launceston,2012,10,2012-10-01,98736,0,98736
Launceston,2012,11,2012-11-01,107299,0,107299
Launceston,2012,12,2012-12-01,119042,0,119042
Launceston,2013,1,2013-01-01,127407,0,127407
Launceston,2013,2,2013-02-01,101438,0,101438
Launceston,2013,3,2013-03-01,115300,0,115300
Launceston,2013,4,2013-04-01,112090,0,112090
Launceston,2013,5,2013-05-01,89347,0,89347
Launceston,2013,6,2013-06-01,82894,0,82894
Launceston,2013,7,2013-07-01,100802,0,100802
Launceston,2013,8,2013-08-01,94050,0,94050
Launceston,2013,9,2013-09-01,92843,0,92843
Launceston,2013,10,2013-10-01,110535,0,110535
Launceston,2013,11,2013-11-01,104324,0,104324
Launceston,2013,12,2013-12-01,126115,0,126115
Launceston,2014,1,2014-01-01,134981,0,134981
Launceston,2014,2,2014-02-01,104308,0,104308
Launceston,2014,3,2014-03-01,117743,0,117743
Launceston,2014,4,2014-04-01,110969,0,110969
Launceston,2014,5,2014-05-01,95670,0,95670
Launceston,2014,6,2014-06-01,93944,0,93944
Launceston,2014,7,2014-07-01,97220,0,97220
Launceston,2014,8,2014-08-01,90439,0,90439
Launceston,2014,9,2014-09-01,95520,0,95520
Launceston,2014,10,2014-10-01,109628,0,109628
Launceston,2014,11,2014-11-01,111351,0,111351
Launceston,2014,12,2014-12-01,127409,0,127409
Launceston,2015,1,2015-01-01,131117,0,131117
Launceston,2015,2,2015-02-01,105078,0,105078
Launceston,2015,3,2015-03-01,117067,0,117067
Launceston,2015,4,2015-04-01,107596,0,107596
Launceston,2015,5,2015-05-01,94902,0,94902
Launceston,2015,6,2015-06-01,84871,0,84871
Launceston,2015,7,2015-07-01,101133,0,101133
Launceston,2015,8,2015-08-01,91516,0,91516
Launceston,2015,9,2015-09-01,93627,0,93627
Launceston,2015,10,2015-10-01,109994,0,109994
Launceston,2015,11,2015-11-01,116342,0,116342
Launceston,2015,12,2015-12-01,133165,0,133165
Launceston,2016,1,2016-01-01,135723,0,135723
Launceston,2016,2,2016-02-01,114135,0,114135
Launceston,2016,3,2016-03-01,122451,0,122451
Launceston,2016,4,2016-04-01,115273,0,115273
Launceston,2016,5,2016-05-01,96652,0,96652
Launceston,2016,6,2016-06-01,90941,0,90941
Launceston,2016,7,2016-07-01,107754,0,107754
Launceston,2016,8,2016-08-01,89603,0,89603
Launceston,2016,9,2016-09-01,99014,0,99014
Launceston,2016,10,2016-10-01,108098,0,108098
Launceston,2016,11,2016-11-01,115117,0,115117
Launceston,2016,12,2016-12-01,136264,0,136264
Launceston,2017,1,2017-01-01,143186,0,143186
Launceston,2017,2,2017-02-01,114286,0,114286
Launceston,2017,3,2017-03-01,120601,0,120601
Launceston,2017,4,2017-04-01,118988,0,118988
Launceston,2017,5,2017-05-01,94302,0,94302
Launceston,2017,6,2017-06-01,87920,0,87920
Launceston,2017,7,2017-07-01,104995,0,104995
Launceston,2017,8,2017-08-01,90076,0,90076
Launceston,2017,9,2017-09-01,98643,0,98643
Launceston,2017,10,2017-10-01,110802,0,110802
Launceston,2017,11,2017-11-01,117211,0,117211
Launceston,2017,12,2017-12-01,140212,0,140212
Launceston,2018,1,2018-01-01,147294,0,147294
Launceston,2018,2,2018-02-01,113834,0,113834
Launceston,2018,3,2018-03-01,132385,0,132385
Launceston,2018,4,2018-04-01,123005,0,123005
Launceston,2018,5,2018-05-01,92783,0,92783
Launceston,2018,6,2018-06-01,91460,0,91460
Launceston,2018,7,2018-07-01,114793,0,114793
Launceston,2018,8,2018-08-01,94629,0,94629
Launceston,2018,9,2018-09-01,100600,0,100600
Launceston,2018,10,2018-10-01,114947,0,114947
Launceston,2018,11,2018-11-01,117220,0,117220
Launceston,2018,12,2018-12-01,138791,0,138791
Launceston,2019,1,2019-01-01,149841,0,149841
Launceston,2019,2,2019-02-01,117262,0,117262
Mackay,2009,1,2009-01-01,79707,0,79707
Mackay,2009,2,2009-02-01,67954,0,67954
Mackay,2009,3,2009-03-01,75713,0,75713
Mackay,2009,4,2009-04-01,76795,0,76795
Mackay,2009,5,2009-05-01,75905,0,75905
Mackay,2009,6,2009-06-01,75327,0,75327
Mackay,2009,7,2009-07-01,80654,0,80654
Mackay,2009,8,2009-08-01,76128,0,76128
Mackay,2009,9,2009-09-01,79124,0,79124
Mackay,2009,10,2009-10-01,82009,0,82009
Mackay,2009,11,2009-11-01,78372,0,78372
Mackay,2009,12,2009-12-01,78001,0,78001
Mackay,2010,1,2010-01-01,73251,0,73251
Mackay,2010,2,2010-02-01,67801,0,67801
Mackay,2010,3,2010-03-01,71371,0,71371
Mackay,2010,4,2010-04-01,73491,0,73491
Mackay,2010,5,2010-05-01,75614,0,75614
Mackay,2010,6,2010-06-01,81422,0,81422
Mackay,2010,7,2010-07-01,87430,0,87430
Mackay,2010,8,2010-08-01,84081,0,84081
Mackay,2010,9,2010-09-01,93091,0,93091
Mackay,2010,10,2010-10-01,95938,0,95938
Mackay,2010,11,2010-11-01,88065,0,88065
Mackay,2010,12,2010-12-01,91512,0,91512
Mackay,2011,1,2011-01-01,91439,0,91439
Mackay,2011,2,2011-02-01,70712,0,70712
Mackay,2011,3,2011-03-01,85846,0,85846
Mackay,2011,4,2011-04-01,84174,0,84174
Mackay,2011,5,2011-05-01,88720,0,88720
Mackay,2011,6,2011-06-01,88164,0,88164
Mackay,2011,7,2011-07-01,93581,0,93581
Mackay,2011,8,2011-08-01,94890,0,94890
Mackay,2011,9,2011-09-01,97626,0,97626
Mackay,2011,10,2011-10-01,100744,0,100744
Mackay,2011,11,2011-11-01,94528,0,94528
Mackay,2011,12,2011-12-01,92177,0,92177
Mackay,2012,1,2012-01-01,86488,0,86488
Mackay,2012,2,2012-02-01,85726,0,85726
Mackay,2012,3,2012-03-01,94071,0,94071
Mackay,2012,4,2012-04-01,92142,0,92142
Mackay,2012,5,2012-05-01,97105,0,97105
Mackay,2012,6,2012-06-01,97069,0,97069
Mackay,2012,7,2012-07-01,98838,0,98838
Mackay,2012,8,2012-08-01,96619,0,96619
Mackay,2012,9,2012-09-01,95863,0,95863
Mackay,2012,10,2012-10-01,98533,0,98533
Mackay,2012,11,2012-11-01,90641,0,90641
Mackay,2012,12,2012-12-01,93148,0,93148
Mackay,2013,1,2013-01-01,90419,0,90419
Mackay,2013,2,2013-02-01,80480,0,80480
Mackay,2013,3,2013-03-01,92017,0,92017
Mackay,2013,4,2013-04-01,94576,0,94576
Mackay,2013,5,2013-05-01,90397,0,90397
Mackay,2013,6,2013-06-01,94400,0,94400
Mackay,2013,7,2013-07-01,98238,0,98238
Mackay,2013,8,2013-08-01,94332,0,94332
Mackay,2013,9,2013-09-01,92710,0,92710
Mackay,2013,10,2013-10-01,97062,0,97062
Mackay,2013,11,2013-11-01,85349,0,85349
Mackay,2013,12,2013-12-01,92614,0,92614
Mackay,2014,1,2014-01-01,80872,0,80872
Mackay,2014,2,2014-02-01,71238,0,71238
Mackay,2014,3,2014-03-01,81108,0,81108
Mackay,2014,4,2014-04-01,82634,0,82634
Mackay,2014,5,2014-05-01,80113,0,80113
Mackay,2014,6,2014-06-01,76918,0,76918
Mackay,2014,7,2014-07-01,88615,0,88615
Mackay,2014,8,2014-08-01,80851,0,80851
Mackay,2014,9,2014-09-01,81841,0,81841
Mackay,2014,10,2014-10-01,88065,0,88065
Mackay,2014,11,2014-11-01,75993,0,75993
Mackay,2014,12,2014-12-01,81715,0,81715
Mackay,2015,1,2015-01-01,70552,0,70552
Mackay,2015,2,2015-02-01,61847,0,61847
Mackay,2015,3,2015-03-01,75432,0,75432
Mackay,2015,4,2015-04-01,76218,0,76218
Mackay,2015,5,2015-05-01,74597,0,74597
Mackay,2015,6,2015-06-01,72628,0,72628
Mackay,2015,7,2015-07-01,80366,0,80366
Mackay,2015,8,2015-08-01,74958,0,74958
Mackay,2015,9,2015-09-01,72682,0,72682
Mackay,2015,10,2015-10-01,72495,0,72495
Mackay,2015,11,2015-11-01,67809,0,67809
Mackay,2015,12,2015-12-01,69348,0,69348
Mackay,2016,1,2016-01-01,59313,0,59313
Mackay,2016,2,2016-02-01,56299,0,56299
Mackay,2016,3,2016-03-01,66480,0,66480
Mackay,2016,4,2016-04-01,65065,0,65065
Mackay,2016,5,2016-05-01,65847,0,65847
Mackay,2016,6,2016-06-01,64408,0,64408
Mackay,2016,7,2016-07-01,67159,0,67159
Mackay,2016,8,2016-08-01,65440,0,65440
Mackay,2016,9,2016-09-01,65815,0,65815
Mackay,2016,10,2016-10-01,66427,0,66427
Mackay,2016,11,2016-11-01,61928,0,61928
Mackay,2016,12,2016-12-01,63472,0,63472
Mackay,2017,1,2017-01-01,55899,0,55899
Mackay,2017,2,2017-02-01,54192,0,54192
Mackay,2017,3,2017-03-01,56272,0,56272
Mackay,2017,4,2017-04-01,65238,0,65238
Mackay,2017,5,2017-05-01,64671,0,64671
Mackay,2017,6,2017-06-01,64241,0,64241
Mackay,2017,7,2017-07-01,66903,0,66903
Mackay,2017,8,2017-08-01,65317,0,65317
Mackay,2017,9,2017-09-01,70075,0,70075
Mackay,2017,10,2017-10-01,69940,0,69940
Mackay,2017,11,2017-11-01,64685,0,64685
Mackay,2017,12,2017-12-01,65570,0,65570
Mackay,2018,1,2018-01-01,61385,0,61385
Mackay,2018,2,2018-02-01,56399,0,56399
Mackay,2018,3,2018-03-01,68038,0,68038
Mackay,2018,4,2018-04-01,62308,0,62308
Mackay,2018,5,2018-05-01,68193,0,68193
Mackay,2018,6,2018-06-01,64327,0,64327
Mackay,2018,7,2018-07-01,77497,0,77497
Mackay,2018,8,2018-08-01,75262,0,75262
Mackay,2018,9,2018-09-01,69217,0,69217
Mackay,2018,10,2018-10-01,70749,0,70749
Mackay,2018,11,2018-11-01,67457,0,67457
Mackay,2018,12,2018-12-01,67134,0,67134
Mackay,2019,1,2019-01-01,62388,0,62388
Mackay,2019,2,2019-02-01,59493,0,59493
Melbourne,2009,1,2009-01-01,1689135,464486,2153621
Melbourne,2009,2,2009-02-01,1485948,378940,1864888
Melbourne,2009,3,2009-03-01,1697698,398919,2096617
Melbourne,2009,4,2009-04-01,1649779,412382,2062161
Melbourne,2009,5,2009-05-01,1551212,371483,1922695
Melbourne,2009,6,2009-06-01,1479867,396792,1876659
Melbourne,2009,7,2009-07-01,1647597,437524,2085121
Melbourne,2009,8,2009-08-01,1650922,409169,2060091
Melbourne,2009,9,2009-09-01,1686877,442531,2129408
Melbourne,2009,10,2009-10-01,1776341,456969,2233310
Melbourne,2009,11,2009-11-01,1740366,447407,2187773
Melbourne,2009,12,2009-12-01,1699476,513750,2213226
Melbourne,2010,1,2010-01-01,1683740,528510,2212250
Melbourne,2010,2,2010-02-01,1611297,448201,2059498
Melbourne,2010,3,2010-03-01,1826339,470925,2297264
Melbourne,2010,4,2010-04-01,1769927,440740,2210667
Melbourne,2010,5,2010-05-01,1682667,409912,2092579
Melbourne,2010,6,2010-06-01,1670623,466182,2136805
Melbourne,2010,7,2010-07-01,1857806,515612,2373418
Melbourne,2010,8,2010-08-01,1833698,473354,2307052
Melbourne,2010,9,2010-09-01,1876531,515192,2391723
Melbourne,2010,10,2010-10-01,1955778,526288,2482066
Melbourne,2010,11,2010-11-01,1862769,491203,2353972
Melbourne,2010,12,2010-12-01,1891078,586392,2477470
Melbourne,2011,1,2011-01-01,1827537,627843,2455380
Melbourne,2011,2,2011-02-01,1610177,495121,2105298
Melbourne,2011,3,2011-03-01,1853100,481748,2334848
Melbourne,2011,4,2011-04-01,1830836,524810,2355646
Melbourne,2011,5,2011-05-01,1748694,478669,2227363
Melbourne,2011,6,2011-06-01,1601351,497247,2098598
Melbourne,2011,7,2011-07-01,1808782,571817,2380599
Melbourne,2011,8,2011-08-01,1752139,521423,2273562
Melbourne,2011,9,2011-09-01,1744591,545803,2290394
Melbourne,2011,10,2011-10-01,1844756,553442,2398198
Melbourne,2011,11,2011-11-01,1794580,537546,2332126
Melbourne,2011,12,2011-12-01,1790003,625489,2415492
Melbourne,2012,1,2012-01-01,1812320,660137,2472457
Melbourne,2012,2,2012-02-01,1651982,524223,2176205
Melbourne,2012,3,2012-03-01,1868393,547293,2415686
Melbourne,2012,4,2012-04-01,1790839,537975,2328814
Melbourne,2012,5,2012-05-01,1745690,489333,2235023
Melbourne,2012,6,2012-06-01,1694538,543399,2237937
Melbourne,2012,7,2012-07-01,1898849,578084,2476933
Melbourne,2012,8,2012-08-01,1864840,547251,2412091
Melbourne,2012,9,2012-09-01,1886222,576431,2462653
Melbourne,2012,10,2012-10-01,1984521,585162,2569683
Melbourne,2012,11,2012-11-01,1991497,571059,2562556
Melbourne,2012,12,2012-12-01,1908659,658895,2567554
Melbourne,2013,1,2013-01-01,1909129,673592,2582721
Melbourne,2013,2,2013-02-01,1699662,535435,2235097
Melbourne,2013,3,2013-03-01,1953940,582585,2536525
Melbourne,2013,4,2013-04-01,1881653,563156,2444809
Melbourne,2013,5,2013-05-01,1782664,532377,2315041
Melbourne,2013,6,2013-06-01,1743116,583479,2326595
Melbourne,2013,7,2013-07-01,2034584,649721,2684305
Melbourne,2013,8,2013-08-01,1951818,624168,2575986
Melbourne,2013,9,2013-09-01,1901804,622717,2524521
Melbourne,2013,10,2013-10-01,2069549,624860,2694409
Melbourne,2013,11,2013-11-01,1972080,593432,2565512
Melbourne,2013,12,2013-12-01,2008285,726621,2734906
Melbourne,2014,1,2014-01-01,1988112,751678,2739790
Melbourne,2014,2,2014-02-01,1754473,589200,2343673
Melbourne,2014,3,2014-03-01,1971872,599597,2571469
Melbourne,2014,4,2014-04-01,1936458,645499,2581957
Melbourne,2014,5,2014-05-01,1833195,599694,2432889
Melbourne,2014,6,2014-06-01,1807665,638937,2446602
Melbourne,2014,7,2014-07-01,2015975,725467,2741442
Melbourne,2014,8,2014-08-01,1955141,664402,2619543
Melbourne,2014,9,2014-09-01,1941656,676862,2618518
Melbourne,2014,10,2014-10-01,2148535,694570,2843105
Melbourne,2014,11,2014-11-01,1996097,664073,2660170
Melbourne,2014,12,2014-12-01,2015148,772487,2787635
Melbourne,2015,1,2015-01-01,1952929,808207,2761136
Melbourne,2015,2,2015-02-01,1792634,678328,2470962
Melbourne,2015,3,2015-03-01,2044947,716520,2761467
Melbourne,2015,4,2015-04-01,1961204,684751,2645955
Melbourne,2015,5,2015-05-01,1872841,636936,2509777
Melbourne,2015,6,2015-06-01,1827552,688338,2515890
Melbourne,2015,7,2015-07-01,2131018,779103,2910121
Melbourne,2015,8,2015-08-01,1981994,732905,2714899
Melbourne,2015,9,2015-09-01,2006378,744426,2750804
Melbourne,2015,10,2015-10-01,2169657,775334,2944991
Melbourne,2015,11,2015-11-01,2078813,736825,2815638
Melbourne,2015,12,2015-12-01,2110930,877643,2988573
Melbourne,2016,1,2016-01-01,2041802,895294,2937096
Melbourne,2016,2,2016-02-01,1920964,764234,2685198
Melbourne,2016,3,2016-03-01,2111913,775782,2887695
Melbourne,2016,4,2016-04-01,2010463,741474,2751937
Melbourne,2016,5,2016-05-01,1944878,690498,2635376
Melbourne,2016,6,2016-06-01,1917216,765416,2682632
Melbourne,2016,7,2016-07-01,2151629,876022,3027651
Melbourne,2016,8,2016-08-01,2015286,780834,2796120
Melbourne,2016,9,2016-09-01,2115140,803333,2918473
Melbourne,2016,10,2016-10-01,2193718,813439,3007157
Melbourne,2016,11,2016-11-01,2147878,780219,2928097
Melbourne,2016,12,2016-12-01,2161716,956041,3117757
Melbourne,2017,1,2017-01-01,2128087,980100,3108187
Melbourne,2017,2,2017-02-01,1861829,778338,2640167
Melbourne,2017,3,2017-03-01,2137402,785165,2922567
Melbourne,2017,4,2017-04-01,2084709,848207,2932916
Melbourne,2017,5,2017-05-01,1976227,740299,2716526
Melbourne,2017,6,2017-06-01,1954427,807461,2761888
Melbourne,2017,7,2017-07-01,2210661,926881,3137542
Melbourne,2017,8,2017-08-01,2059224,840515,2899739
Melbourne,2017,9,2017-09-01,2109572,866933,2976505
Melbourne,2017,10,2017-10-01,2290350,883230,3173580
Melbourne,2017,11,2017-11-01,2221211,851387,3072598
Melbourne,2017,12,2017-12-01,2202040,1015266,3217306
Melbourne,2018,1,2018-01-01,2170968,1020724,3191692
Melbourne,2018,2,2018-02-01,1927548,871187,2798735
Melbourne,2018,3,2018-03-01,2226583,909908,3136491
Melbourne,2018,4,2018-04-01,2136018,894262,3030280
Melbourne,2018,5,2018-05-01,2007811,800820,2808631
Melbourne,2018,6,2018-06-01,1972614,902957,2875571
Melbourne,2018,7,2018-07-01,2265448,994216,3259664
Melbourne,2018,8,2018-08-01,2143001,938116,3081117
Melbourne,2018,9,2018-09-01,2131638,951501,3083139
Melbourne,2018,10,2018-10-01,2309063,960308,3269371
Melbourne,2018,11,2018-11-01,2224829,935091,3159920
Melbourne,2018,12,2018-12-01,2177224,1044794,3222018
Melbourne,2019,1,2019-01-01,2188064,1070087,3258151
Melbourne,2019,2,2019-02-01,1952723,889344,2842067
Newcastle,2009,1,2009-01-01,103394,0,103394
Newcastle,2009,2,2009-02-01,85201,0,85201
Newcastle,2009,3,2009-03-01,98019,0,98019
Newcastle,2009,4,2009-04-01,97912,0,97912
Newcastle,2009,5,2009-05-01,94768,0,94768
Newcastle,2009,6,2009-06-01,84566,0,84566
Newcastle,2009,7,2009-07-01,96489,0,96489
Newcastle,2009,8,2009-08-01,94027,0,94027
Newcastle,2009,9,2009-09-01,93290,0,93290
Newcastle,2009,10,2009-10-01,100959,0,100959
Newcastle,2009,11,2009-11-01,96301,0,96301
Newcastle,2009,12,2009-12-01,92811,0,92811
Newcastle,2010,1,2010-01-01,91421,0,91421
Newcastle,2010,2,2010-02-01,84654,0,84654
Newcastle,2010,3,2010-03-01,98699,0,98699
Newcastle,2010,4,2010-04-01,96872,0,96872
Newcastle,2010,5,2010-05-01,92294,0,92294
Newcastle,2010,6,2010-06-01,89575,0,89575
Newcastle,2010,7,2010-07-01,101983,0,101983
Newcastle,2010,8,2010-08-01,97481,0,97481
Newcastle,2010,9,2010-09-01,102135,0,102135
Newcastle,2010,10,2010-10-01,111975,0,111975
Newcastle,2010,11,2010-11-01,107502,0,107502
Newcastle,2010,12,2010-12-01,111376,0,111376
Newcastle,2011,1,2011-01-01,105668,0,105668
Newcastle,2011,2,2011-02-01,88141,0,88141
Newcastle,2011,3,2011-03-01,101958,0,101958
Newcastle,2011,4,2011-04-01,101326,0,101326
Newcastle,2011,5,2011-05-01,96319,0,96319
Newcastle,2011,6,2011-06-01,85438,0,85438
Newcastle,2011,7,2011-07-01,100865,0,100865
Newcastle,2011,8,2011-08-01,98732,0,98732
Newcastle,2011,9,2011-09-01,101285,0,101285
Newcastle,2011,10,2011-10-01,108960,0,108960
Newcastle,2011,11,2011-11-01,101660,0,101660
Newcastle,2011,12,2011-12-01,100807,0,100807
Newcastle,2012,1,2012-01-01,100810,0,100810
Newcastle,2012,2,2012-02-01,90937,0,90937
Newcastle,2012,3,2012-03-01,104070,0,104070
Newcastle,2012,4,2012-04-01,96764,0,96764
Newcastle,2012,5,2012-05-01,98493,0,98493
Newcastle,2012,6,2012-06-01,90793,0,90793
Newcastle,2012,7,2012-07-01,98741,0,98741
Newcastle,2012,8,2012-08-01,96318,0,96318
Newcastle,2012,9,2012-09-01,100083,0,100083
Newcastle,2012,10,2012-10-01,104490,0,104490
Newcastle,2012,11,2012-11-01,102998,0,102998
Newcastle,2012,12,2012-12-01,99926,0,99926
Newcastle,2013,1,2013-01-01,98439,0,98439
Newcastle,2013,2,2013-02-01,87684,0,87684
Newcastle,2013,3,2013-03-01,101633,0,101633
Newcastle,2013,4,2013-04-01,102297,0,102297
Newcastle,2013,5,2013-05-01,94671,0,94671
Newcastle,2013,6,2013-06-01,90777,0,90777
Newcastle,2013,7,2013-07-01,104093,0,104093
Newcastle,2013,8,2013-08-01,100632,0,100632
Newcastle,2013,9,2013-09-01,103907,0,103907
Newcastle,2013,10,2013-10-01,109133,0,109133
Newcastle,2013,11,2013-11-01,107777,0,107777
Newcastle,2013,12,2013-12-01,105474,0,105474
Newcastle,2014,1,2014-01-01,101666,0,101666
Newcastle,2014,2,2014-02-01,86129,0,86129
Newcastle,2014,3,2014-03-01,100653,0,100653
Newcastle,2014,4,2014-04-01,95541,0,95541
Newcastle,2014,5,2014-05-01,94941,0,94941
Newcastle,2014,6,2014-06-01,90266,0,90266
Newcastle,2014,7,2014-07-01,101529,0,101529
Newcastle,2014,8,2014-08-01,97284,0,97284
Newcastle,2014,9,2014-09-01,100260,0,100260
Newcastle,2014,10,2014-10-01,107166,0,107166
Newcastle,2014,11,2014-11-01,97264,0,97264
Newcastle,2014,12,2014-12-01,95844,0,95844
Newcastle,2015,1,2015-01-01,93178,0,93178
Newcastle,2015,2,2015-02-01,80225,0,80225
Newcastle,2015,3,2015-03-01,93900,0,93900
Newcastle,2015,4,2015-04-01,92850,0,92850
Newcastle,2015,5,2015-05-01,93417,0,93417
Newcastle,2015,6,2015-06-01,90921,0,90921
Newcastle,2015,7,2015-07-01,103879,0,103879
Newcastle,2015,8,2015-08-01,95725,0,95725
Newcastle,2015,9,2015-09-01,100315,0,100315
Newcastle,2015,10,2015-10-01,106340,0,106340
Newcastle,2015,11,2015-11-01,99412,0,99412
Newcastle,2015,12,2015-12-01,100512,0,100512
Newcastle,2016,1,2016-01-01,95227,0,95227
Newcastle,2016,2,2016-02-01,89433,0,89433
Newcastle,2016,3,2016-03-01,101092,0,101092
Newcastle,2016,4,2016-04-01,94806,0,94806
Newcastle,2016,5,2016-05-01,95929,0,95929
Newcastle,2016,6,2016-06-01,92194,0,92194
Newcastle,2016,7,2016-07-01,106042,0,106042
Newcastle,2016,8,2016-08-01,100869,0,100869
Newcastle,2016,9,2016-09-01,108062,0,108062
Newcastle,2016,10,2016-10-01,113825,0,113825
Newcastle,2016,11,2016-11-01,105703,0,105703
Newcastle,2016,12,2016-12-01,107930,0,107930
Newcastle,2017,1,2017-01-01,108376,0,108376
Newcastle,2017,2,2017-02-01,89924,0,89924
Newcastle,2017,3,2017-03-01,104459,0,104459
Newcastle,2017,4,2017-04-01,108573,0,108573
Newcastle,2017,5,2017-05-01,100066,0,100066
Newcastle,2017,6,2017-06-01,95732,0,95732
Newcastle,2017,7,2017-07-01,108616,0,108616
Newcastle,2017,8,2017-08-01,99173,0,99173
Newcastle,2017,9,2017-09-01,110149,0,110149
Newcastle,2017,10,2017-10-01,116130,0,116130
Newcastle,2017,11,2017-11-01,111413,0,111413
Newcastle,2017,12,2017-12-01,112700,0,112700
Newcastle,2018,1,2018-01-01,104773,0,104773
Newcastle,2018,2,2018-02-01,92772,0,92772
Newcastle,2018,3,2018-03-01,107098,0,107098
Newcastle,2018,4,2018-04-01,105270,0,105270
Newcastle,2018,5,2018-05-01,101884,0,101884
Newcastle,2018,6,2018-06-01,95026,0,95026
Newcastle,2018,7,2018-07-01,109087,0,109087
Newcastle,2018,8,2018-08-01,103413,0,103413
Newcastle,2018,9,2018-09-01,101570,0,101570
Newcastle,2018,10,2018-10-01,111884,0,111884
Newcastle,2018,11,2018-11-01,112039,574,112613
Newcastle,2018,12,2018-12-01,106313,2166,108479
Newcastle,2019,1,2019-01-01,106963,2853,109816
Newcastle,2019,2,2019-02-01,91797,1094,92891
Perth,2009,1,2009-01-01,572528,260880,833408
Perth,2009,2,2009-02-01,487285,190896,678181
Perth,2009,3,2009-03-01,580649,203169,783818
Perth,2009,4,2009-04-01,578264,223465,801729
Perth,2009,5,2009-05-01,550436,196896,747332
Perth,2009,6,2009-06-01,524096,213201,737297
Perth,2009,7,2009-07-01,604014,240433,844447
Perth,2009,8,2009-08-01,573336,217632,790968
Perth,2009,9,2009-09-01,588922,242895,831817
Perth,2009,10,2009-10-01,616567,258197,874764
Perth,2009,11,2009-11-01,577248,243717,820965
Perth,2009,12,2009-12-01,587692,283356,871048
Perth,2010,1,2010-01-01,574900,295381,870281
Perth,2010,2,2010-02-01,518406,225992,744398
Perth,2010,3,2010-03-01,619243,251849,871092
Perth,2010,4,2010-04-01,605279,244898,850177
Perth,2010,5,2010-05-01,574110,218752,792862
Perth,2010,6,2010-06-01,570994,258775,829769
Perth,2010,7,2010-07-01,640536,281742,922278
Perth,2010,8,2010-08-01,612874,249745,862619
Perth,2010,9,2010-09-01,632695,273925,906620
Perth,2010,10,2010-10-01,670675,282272,952947
Perth,2010,11,2010-11-01,637763,252043,889806
Perth,2010,12,2010-12-01,662378,298335,960713
Perth,2011,1,2011-01-01,633375,323861,957236
Perth,2011,2,2011-02-01,550219,241861,792080
Perth,2011,3,2011-03-01,661614,248100,909714
Perth,2011,4,2011-04-01,661530,274092,935622
Perth,2011,5,2011-05-01,665469,253549,919018
Perth,2011,6,2011-06-01,615319,265631,880950
Perth,2011,7,2011-07-01,707274,306560,1013834
Perth,2011,8,2011-08-01,696088,267113,963201
Perth,2011,9,2011-09-01,691838,285045,976883
Perth,2011,10,2011-10-01,709098,301321,1010419
Perth,2011,11,2011-11-01,716150,270318,986468
Perth,2011,12,2011-12-01,708058,312017,1020075
Perth,2012,1,2012-01-01,713610,336792,1050402
Perth,2012,2,2012-02-01,654247,261096,915343
Perth,2012,3,2012-03-01,741660,281963,1023623
Perth,2012,4,2012-04-01,736077,300178,1036255
Perth,2012,5,2012-05-01,737858,258297,996155
Perth,2012,6,2012-06-01,715078,289058,1004136
Perth,2012,7,2012-07-01,799183,323088,1122271
Perth,2012,8,2012-08-01,775021,286810,1061831
Perth,2012,9,2012-09-01,763836,310760,1074596
Perth,2012,10,2012-10-01,832739,330018,1162757
Perth,2012,11,2012-11-01,770604,293318,1063922
Perth,2012,12,2012-12-01,759658,347390,1107048
Perth,2013,1,2013-01-01,756864,367962,1124826
Perth,2013,2,2013-02-01,642458,278377,920835
Perth,2013,3,2013-03-01,761463,303379,1064842
Perth,2013,4,2013-04-01,775099,306529,1081628
Perth,2013,5,2013-05-01,753255,291548,1044803
Perth,2013,6,2013-06-01,700089,302421,1002510
Perth,2013,7,2013-07-01,810895,356942,1167837
Perth,2013,8,2013-08-01,747462,320500,1067962
Perth,2013,9,2013-09-01,747305,335673,1082978
Perth,2013,10,2013-10-01,807825,348468,1156293
Perth,2013,11,2013-11-01,725938,310162,1036100
Perth,2013,12,2013-12-01,753219,397879,1151098
Perth,2014,1,2014-01-01,758600,433321,1191921
Perth,2014,2,2014-02-01,650752,304688,955440
Perth,2014,3,2014-03-01,731594,315230,1046824
Perth,2014,4,2014-04-01,767264,358776,1126040
Perth,2014,5,2014-05-01,706266,301123,1007389
Perth,2014,6,2014-06-01,673029,316799,989828
Perth,2014,7,2014-07-01,769306,384777,1154083
Perth,2014,8,2014-08-01,719835,330424,1050259
Perth,2014,9,2014-09-01,729205,361367,1090572
Perth,2014,10,2014-10-01,800553,363136,1163689
Perth,2014,11,2014-11-01,712059,315336,1027395
Perth,2014,12,2014-12-01,740056,395430,1135486
Perth,2015,1,2015-01-01,710044,423008,1133052
Perth,2015,2,2015-02-01,614778,314338,929116
Perth,2015,3,2015-03-01,710527,327872,1038399
Perth,2015,4,2015-04-01,723283,342258,1065541
Perth,2015,5,2015-05-01,665346,301409,966755
Perth,2015,6,2015-06-01,650149,325622,975771
Perth,2015,7,2015-07-01,764653,386492,1151145
Perth,2015,8,2015-08-01,685115,335142,1020257
Perth,2015,9,2015-09-01,699543,354427,1053970
Perth,2015,10,2015-10-01,748228,361122,1109350
Perth,2015,11,2015-11-01,699179,317970,1017149
Perth,2015,12,2015-12-01,730687,403173,1133860
Perth,2016,1,2016-01-01,688600,433983,1122583
Perth,2016,2,2016-02-01,605234,333991,939225
Perth,2016,3,2016-03-01,695807,343473,1039280
Perth,2016,4,2016-04-01,683411,353191,1036602
Perth,2016,5,2016-05-01,648126,307965,956091
Perth,2016,6,2016-06-01,636356,340182,976538
Perth,2016,7,2016-07-01,704946,403378,1108324
Perth,2016,8,2016-08-01,664744,341209,1005953
Perth,2016,9,2016-09-01,693449,379212,1072661
Perth,2016,10,2016-10-01,712408,378835,1091243
Perth,2016,11,2016-11-01,677612,340917,1018529
Perth,2016,12,2016-12-01,714793,422839,1137632
Perth,2017,1,2017-01-01,690641,436652,1127293
Perth,2017,2,2017-02-01,569834,328014,897848
Perth,2017,3,2017-03-01,663410,343748,1007158
Perth,2017,4,2017-04-01,668963,379485,1048448
Perth,2017,5,2017-05-01,642626,321134,963760
Perth,2017,6,2017-06-01,622626,348410,971036
Perth,2017,7,2017-07-01,701703,394005,1095708
Perth,2017,8,2017-08-01,658247,345460,1003707
Perth,2017,9,2017-09-01,665713,372232,1037945
Perth,2017,10,2017-10-01,714719,376731,1091450
Perth,2017,11,2017-11-01,681111,330684,1011795
Perth,2017,12,2017-12-01,705432,408912,1114344
Perth,2018,1,2018-01-01,693490,420932,1114422
Perth,2018,2,2018-02-01,587505,320699,908204
Perth,2018,3,2018-03-01,687018,351509,1038527
Perth,2018,4,2018-04-01,684014,356243,1040257
Perth,2018,5,2018-05-01,664794,321592,986386
Perth,2018,6,2018-06-01,620514,355647,976161
Perth,2018,7,2018-07-01,717060,396045,1113105
Perth,2018,8,2018-08-01,663424,357102,1020526
Perth,2018,9,2018-09-01,684915,370754,1055669
Perth,2018,10,2018-10-01,731068,360327,1091395
Perth,2018,11,2018-11-01,688113,337264,1025377
Perth,2018,12,2018-12-01,689980,417857,1107837
Perth,2019,1,2019-01-01,688800,422061,1110861
Perth,2019,2,2019-02-01,582619,324918,907537
Proserpine,2009,1,2009-01-01,19787,0,19787
Proserpine,2009,2,2009-02-01,16058,0,16058
Proserpine,2009,3,2009-03-01,18291,0,18291
Proserpine,2009,4,2009-04-01,18014,0,18014
Proserpine,2009,5,2009-05-01,17453,0,17453
Proserpine,2009,6,2009-06-01,17200,0,17200
Proserpine,2009,7,2009-07-01,18800,0,18800
Proserpine,2009,8,2009-08-01,19540,0,19540
Proserpine,2009,9,2009-09-01,19168,0,19168
Proserpine,2009,10,2009-10-01,19749,0,19749
Proserpine,2009,11,2009-11-01,18861,0,18861
Proserpine,2009,12,2009-12-01,17943,0,17943
Proserpine,2010,1,2010-01-01,17298,0,17298
Proserpine,2010,2,2010-02-01,15862,0,15862
Proserpine,2010,3,2010-03-01,15774,0,15774
Proserpine,2010,4,2010-04-01,17205,0,17205
Proserpine,2010,5,2010-05-01,16519,0,16519
Proserpine,2010,6,2010-06-01,16900,0,16900
Proserpine,2010,7,2010-07-01,18417,0,18417
Proserpine,2010,8,2010-08-01,18548,0,18548
Proserpine,2010,9,2010-09-01,18227,0,18227
Proserpine,2010,10,2010-10-01,19369,0,19369
Proserpine,2010,11,2010-11-01,18447,0,18447
Proserpine,2010,12,2010-12-01,17950,0,17950
Proserpine,2011,1,2011-01-01,17574,0,17574
Proserpine,2011,2,2011-02-01,12686,0,12686
Proserpine,2011,3,2011-03-01,15519,0,15519
Proserpine,2011,4,2011-04-01,16480,0,16480
Proserpine,2011,5,2011-05-01,16223,0,16223
Proserpine,2011,6,2011-06-01,15996,0,15996
Proserpine,2011,7,2011-07-01,18173,0,18173
Proserpine,2011,8,2011-08-01,18733,0,18733
Proserpine,2011,9,2011-09-01,18646,0,18646
Proserpine,2011,10,2011-10-01,19427,0,19427
Proserpine,2011,11,2011-11-01,17979,0,17979
Proserpine,2011,12,2011-12-01,17506,0,17506
Proserpine,2012,1,2012-01-01,17497,0,17497
Proserpine,2012,2,2012-02-01,14088,0,14088
Proserpine,2012,3,2012-03-01,17843,0,17843
Proserpine,2012,4,2012-04-01,19416,0,19416
Proserpine,2012,5,2012-05-01,17812,0,17812
Proserpine,2012,6,2012-06-01,18463,0,18463
Proserpine,2012,7,2012-07-01,21613,0,21613
Proserpine,2012,8,2012-08-01,20487,0,20487
Proserpine,2012,9,2012-09-01,20713,0,20713
Proserpine,2012,10,2012-10-01,22739,0,22739
Proserpine,2012,11,2012-11-01,21591,0,21591
Proserpine,2012,12,2012-12-01,20551,0,20551
Proserpine,2013,1,2013-01-01,20583,0,20583
Proserpine,2013,2,2013-02-01,15730,0,15730
Proserpine,2013,3,2013-03-01,17361,0,17361
Proserpine,2013,4,2013-04-01,19115,0,19115
Proserpine,2013,5,2013-05-01,16908,0,16908
Proserpine,2013,6,2013-06-01,17661,0,17661
Proserpine,2013,7,2013-07-01,21195,0,21195
Proserpine,2013,8,2013-08-01,20312,0,20312
Proserpine,2013,9,2013-09-01,21051,0,21051
Proserpine,2013,10,2013-10-01,22250,0,22250
Proserpine,2013,11,2013-11-01,20635,0,20635
Proserpine,2013,12,2013-12-01,21601,0,21601
Proserpine,2014,1,2014-01-01,20500,0,20500
Proserpine,2014,2,2014-02-01,16288,0,16288
Proserpine,2014,3,2014-03-01,18131,0,18131
Proserpine,2014,4,2014-04-01,22114,0,22114
Proserpine,2014,5,2014-05-01,20307,0,20307
Proserpine,2014,6,2014-06-01,20083,0,20083
Proserpine,2014,7,2014-07-01,24036,0,24036
Proserpine,2014,8,2014-08-01,23583,0,23583
Proserpine,2014,9,2014-09-01,24230,0,24230
Proserpine,2014,10,2014-10-01,26030,0,26030
Proserpine,2014,11,2014-11-01,23990,0,23990
Proserpine,2014,12,2014-12-01,25046,0,25046
Proserpine,2015,1,2015-01-01,24786,0,24786
Proserpine,2015,2,2015-02-01,20793,0,20793
Proserpine,2015,3,2015-03-01,21229,0,21229
Proserpine,2015,4,2015-04-01,24759,0,24759
Proserpine,2015,5,2015-05-01,20734,0,20734
Proserpine,2015,6,2015-06-01,21632,0,21632
Proserpine,2015,7,2015-07-01,30707,0,30707
Proserpine,2015,8,2015-08-01,29885,0,29885
Proserpine,2015,9,2015-09-01,30482,0,30482
Proserpine,2015,10,2015-10-01,32223,0,32223
Proserpine,2015,11,2015-11-01,30212,0,30212
Proserpine,2015,12,2015-12-01,31687,0,31687
Proserpine,2016,1,2016-01-01,31132,0,31132
Proserpine,2016,2,2016-02-01,27290,0,27290
Proserpine,2016,3,2016-03-01,27934,0,27934
Proserpine,2016,4,2016-04-01,27430,0,27430
Proserpine,2016,5,2016-05-01,24224,0,24224
Proserpine,2016,6,2016-06-01,24824,0,24824
Proserpine,2016,7,2016-07-01,29183,0,29183
Proserpine,2016,8,2016-08-01,29028,0,29028
Proserpine,2016,9,2016-09-01,29677,0,29677
Proserpine,2016,10,2016-10-01,31697,0,31697
Proserpine,2016,11,2016-11-01,27657,0,27657
Proserpine,2016,12,2016-12-01,32762,0,32762
Proserpine,2017,1,2017-01-01,31637,0,31637
Proserpine,2017,2,2017-02-01,24321,0,24321
Proserpine,2017,3,2017-03-01,23228,0,23228
Proserpine,2017,4,2017-04-01,30614,0,30614
Proserpine,2017,5,2017-05-01,30248,0,30248
Proserpine,2017,6,2017-06-01,33020,0,33020
Proserpine,2017,7,2017-07-01,41023,0,41023
Proserpine,2017,8,2017-08-01,39456,0,39456
Proserpine,2017,9,2017-09-01,42010,0,42010
Proserpine,2017,10,2017-10-01,43647,0,43647
Proserpine,2017,11,2017-11-01,41306,0,41306
Proserpine,2017,12,2017-12-01,45061,0,45061
Proserpine,2018,1,2018-01-01,44938,0,44938
Proserpine,2018,2,2018-02-01,37254,0,37254
Proserpine,2018,3,2018-03-01,36965,0,36965
Proserpine,2018,4,2018-04-01,36112,0,36112
Proserpine,2018,5,2018-05-01,31221,0,31221
Proserpine,2018,6,2018-06-01,30965,0,30965
Proserpine,2018,7,2018-07-01,39968,0,39968
Proserpine,2018,8,2018-08-01,37955,0,37955
Proserpine,2018,9,2018-09-01,38293,0,38293
Proserpine,2018,10,2018-10-01,41867,0,41867
Proserpine,2018,11,2018-11-01,35848,0,35848
Proserpine,2018,12,2018-12-01,37189,0,37189
Proserpine,2019,1,2019-01-01,38331,0,38331
Proserpine,2019,2,2019-02-01,29292,0,29292
Rockhampton,2009,1,2009-01-01,55654,0,55654
Rockhampton,2009,2,2009-02-01,52148,0,52148
Rockhampton,2009,3,2009-03-01,61228,0,61228
Rockhampton,2009,4,2009-04-01,60084,0,60084
Rockhampton,2009,5,2009-05-01,64202,0,64202
Rockhampton,2009,6,2009-06-01,62058,0,62058
Rockhampton,2009,7,2009-07-01,68050,0,68050
Rockhampton,2009,8,2009-08-01,65941,0,65941
Rockhampton,2009,9,2009-09-01,64178,0,64178
Rockhampton,2009,10,2009-10-01,64903,0,64903
Rockhampton,2009,11,2009-11-01,61914,0,61914
Rockhampton,2009,12,2009-12-01,62977,0,62977
Rockhampton,2010,1,2010-01-01,55477,0,55477
Rockhampton,2010,2,2010-02-01,58127,0,58127
Rockhampton,2010,3,2010-03-01,63175,0,63175
Rockhampton,2010,4,2010-04-01,65347,0,65347
Rockhampton,2010,5,2010-05-01,63603,0,63603
Rockhampton,2010,6,2010-06-01,63712,0,63712
Rockhampton,2010,7,2010-07-01,64941,0,64941
Rockhampton,2010,8,2010-08-01,66111,0,66111
Rockhampton,2010,9,2010-09-01,69657,0,69657
Rockhampton,2010,10,2010-10-01,69640,0,69640
Rockhampton,2010,11,2010-11-01,67980,0,67980
Rockhampton,2010,12,2010-12-01,69442,0,69442
Rockhampton,2011,1,2011-01-01,10385,0,10385
Rockhampton,2011,2,2011-02-01,49801,0,49801
Rockhampton,2011,3,2011-03-01,62278,0,62278
Rockhampton,2011,4,2011-04-01,61645,0,61645
Rockhampton,2011,5,2011-05-01,64261,0,64261
Rockhampton,2011,6,2011-06-01,63664,0,63664
Rockhampton,2011,7,2011-07-01,66912,0,66912
Rockhampton,2011,8,2011-08-01,64887,0,64887
Rockhampton,2011,9,2011-09-01,66844,0,66844
Rockhampton,2011,10,2011-10-01,66160,0,66160
Rockhampton,2011,11,2011-11-01,63216,0,63216
Rockhampton,2011,12,2011-12-01,60974,0,60974
Rockhampton,2012,1,2012-01-01,55531,0,55531
Rockhampton,2012,2,2012-02-01,55938,0,55938
Rockhampton,2012,3,2012-03-01,64688,0,64688
Rockhampton,2012,4,2012-04-01,57763,0,57763
Rockhampton,2012,5,2012-05-01,65553,0,65553
Rockhampton,2012,6,2012-06-01,62167,0,62167
Rockhampton,2012,7,2012-07-01,65993,0,65993
Rockhampton,2012,8,2012-08-01,64658,0,64658
Rockhampton,2012,9,2012-09-01,63168,0,63168
Rockhampton,2012,10,2012-10-01,65962,0,65962
Rockhampton,2012,11,2012-11-01,61360,0,61360
Rockhampton,2012,12,2012-12-01,57696,0,57696
Rockhampton,2013,1,2013-01-01,51121,0,51121
Rockhampton,2013,2,2013-02-01,47229,0,47229
Rockhampton,2013,3,2013-03-01,59935,0,59935
Rockhampton,2013,4,2013-04-01,59603,0,59603
Rockhampton,2013,5,2013-05-01,57483,0,57483
Rockhampton,2013,6,2013-06-01,56893,0,56893
Rockhampton,2013,7,2013-07-01,64671,0,64671
Rockhampton,2013,8,2013-08-01,62255,0,62255
Rockhampton,2013,9,2013-09-01,59624,0,59624
Rockhampton,2013,10,2013-10-01,63772,0,63772
Rockhampton,2013,11,2013-11-01,56824,0,56824
Rockhampton,2013,12,2013-12-01,57092,0,57092
Rockhampton,2014,1,2014-01-01,49213,0,49213
Rockhampton,2014,2,2014-02-01,46864,0,46864
Rockhampton,2014,3,2014-03-01,55724,0,55724
Rockhampton,2014,4,2014-04-01,54951,0,54951
Rockhampton,2014,5,2014-05-01,55726,0,55726
Rockhampton,2014,6,2014-06-01,54671,0,54671
Rockhampton,2014,7,2014-07-01,58457,0,58457
Rockhampton,2014,8,2014-08-01,55511,0,55511
Rockhampton,2014,9,2014-09-01,57908,0,57908
Rockhampton,2014,10,2014-10-01,58952,0,58952
Rockhampton,2014,11,2014-11-01,52517,0,52517
Rockhampton,2014,12,2014-12-01,50917,0,50917
Rockhampton,2015,1,2015-01-01,44647,0,44647
Rockhampton,2015,2,2015-02-01,39612,0,39612
Rockhampton,2015,3,2015-03-01,55559,0,55559
Rockhampton,2015,4,2015-04-01,52296,0,52296
Rockhampton,2015,5,2015-05-01,55782,0,55782
Rockhampton,2015,6,2015-06-01,52755,0,52755
Rockhampton,2015,7,2015-07-01,56302,0,56302
Rockhampton,2015,8,2015-08-01,51461,0,51461
Rockhampton,2015,9,2015-09-01,52126,0,52126
Rockhampton,2015,10,2015-10-01,53146,0,53146
Rockhampton,2015,11,2015-11-01,51476,0,51476
Rockhampton,2015,12,2015-12-01,49303,0,49303
Rockhampton,2016,1,2016-01-01,40123,0,40123
Rockhampton,2016,2,2016-02-01,42181,0,42181
Rockhampton,2016,3,2016-03-01,48727,0,48727
Rockhampton,2016,4,2016-04-01,48206,0,48206
Rockhampton,2016,5,2016-05-01,50247,0,50247
Rockhampton,2016,6,2016-06-01,49540,0,49540
Rockhampton,2016,7,2016-07-01,50596,0,50596
Rockhampton,2016,8,2016-08-01,50580,0,50580
Rockhampton,2016,9,2016-09-01,52293,0,52293
Rockhampton,2016,10,2016-10-01,50874,0,50874
Rockhampton,2016,11,2016-11-01,49766,0,49766
Rockhampton,2016,12,2016-12-01,51114,0,51114
Rockhampton,2017,1,2017-01-01,41830,0,41830
Rockhampton,2017,2,2017-02-01,41992,0,41992
Rockhampton,2017,3,2017-03-01,49463,0,49463
Rockhampton,2017,4,2017-04-01,30107,0,30107
Rockhampton,2017,5,2017-05-01,48829,0,48829
Rockhampton,2017,6,2017-06-01,48472,0,48472
Rockhampton,2017,7,2017-07-01,53060,0,53060
Rockhampton,2017,8,2017-08-01,49997,0,49997
Rockhampton,2017,9,2017-09-01,49988,0,49988
Rockhampton,2017,10,2017-10-01,50884,0,50884
Rockhampton,2017,11,2017-11-01,46653,0,46653
Rockhampton,2017,12,2017-12-01,45239,0,45239
Rockhampton,2018,1,2018-01-01,40418,0,40418
Rockhampton,2018,2,2018-02-01,38745,0,38745
Rockhampton,2018,3,2018-03-01,47560,0,47560
Rockhampton,2018,4,2018-04-01,43219,0,43219
Rockhampton,2018,5,2018-05-01,51992,0,51992
Rockhampton,2018,6,2018-06-01,45776,0,45776
Rockhampton,2018,7,2018-07-01,47491,0,47491
Rockhampton,2018,8,2018-08-01,50029,0,50029
Rockhampton,2018,9,2018-09-01,46663,0,46663
Rockhampton,2018,10,2018-10-01,49297,0,49297
Rockhampton,2018,11,2018-11-01,45955,0,45955
Rockhampton,2018,12,2018-12-01,44451,0,44451
Rockhampton,2019,1,2019-01-01,40930,0,40930
Rockhampton,2019,2,2019-02-01,40514,0,40514
Sunshine Coast,2009,1,2009-01-01,93362,0,93362
Sunshine Coast,2009,2,2009-02-01,63218,0,63218
Sunshine Coast,2009,3,2009-03-01,71787,0,71787
Sunshine Coast,2009,4,2009-04-01,75437,0,75437
Sunshine Coast,2009,5,2009-05-01,68381,0,68381
Sunshine Coast,2009,6,2009-06-01,62643,0,62643
Sunshine Coast,2009,7,2009-07-01,70486,0,70486
Sunshine Coast,2009,8,2009-08-01,71807,0,71807
Sunshine Coast,2009,9,2009-09-01,69520,0,69520
Sunshine Coast,2009,10,2009-10-01,76217,0,76217
Sunshine Coast,2009,11,2009-11-01,70760,0,70760
Sunshine Coast,2009,12,2009-12-01,65389,0,65389
Sunshine Coast,2010,1,2010-01-01,72230,0,72230
Sunshine Coast,2010,2,2010-02-01,57944,0,57944
Sunshine Coast,2010,3,2010-03-01,62391,0,62391
Sunshine Coast,2010,4,2010-04-01,71662,0,71662
Sunshine Coast,2010,5,2010-05-01,62952,0,62952
Sunshine Coast,2010,6,2010-06-01,61048,0,61048
Sunshine Coast,2010,7,2010-07-01,77453,0,77453
Sunshine Coast,2010,8,2010-08-01,72808,0,72808
Sunshine Coast,2010,9,2010-09-01,77583,0,77583
Sunshine Coast,2010,10,2010-10-01,84605,0,84605
Sunshine Coast,2010,11,2010-11-01,80093,0,80093
Sunshine Coast,2010,12,2010-12-01,82900,0,82900
Sunshine Coast,2011,1,2011-01-01,89194,0,89194
Sunshine Coast,2011,2,2011-02-01,60808,0,60808
Sunshine Coast,2011,3,2011-03-01,71818,0,71818
Sunshine Coast,2011,4,2011-04-01,85790,0,85790
Sunshine Coast,2011,5,2011-05-01,68820,0,68820
Sunshine Coast,2011,6,2011-06-01,62303,0,62303
Sunshine Coast,2011,7,2011-07-01,76530,0,76530
Sunshine Coast,2011,8,2011-08-01,64266,0,64266
Sunshine Coast,2011,9,2011-09-01,70035,0,70035
Sunshine Coast,2011,10,2011-10-01,71396,0,71396
Sunshine Coast,2011,11,2011-11-01,64825,0,64825
Sunshine Coast,2011,12,2011-12-01,71630,0,71630
Sunshine Coast,2012,1,2012-01-01,79420,0,79420
Sunshine Coast,2012,2,2012-02-01,54322,0,54322
Sunshine Coast,2012,3,2012-03-01,59557,0,59557
Sunshine Coast,2012,4,2012-04-01,65560,0,65560
Sunshine Coast,2012,5,2012-05-01,57488,0,57488
Sunshine Coast,2012,6,2012-06-01,56080,0,56080
Sunshine Coast,2012,7,2012-07-01,67608,2284,69892
Sunshine Coast,2012,8,2012-08-01,59358,2032,61390
Sunshine Coast,2012,9,2012-09-01,73355,1397,74752
Sunshine Coast,2012,10,2012-10-01,73165,0,73165
Sunshine Coast,2012,11,2012-11-01,70945,0,70945
Sunshine Coast,2012,12,2012-12-01,72804,0,72804
Sunshine Coast,2013,1,2013-01-01,74443,0,74443
Sunshine Coast,2013,2,2013-02-01,49370,0,49370
Sunshine Coast,2013,3,2013-03-01,62961,0,62961
Sunshine Coast,2013,4,2013-04-01,73488,0,73488
Sunshine Coast,2013,5,2013-05-01,59963,0,59963
Sunshine Coast,2013,6,2013-06-01,64970,840,65810
Sunshine Coast,2013,7,2013-07-01,74897,2233,77130
Sunshine Coast,2013,8,2013-08-01,72365,2026,74391
Sunshine Coast,2013,9,2013-09-01,80377,2264,82641
Sunshine Coast,2013,10,2013-10-01,83004,1042,84046
Sunshine Coast,2013,11,2013-11-01,78130,0,78130
Sunshine Coast,2013,12,2013-12-01,84131,0,84131
Sunshine Coast,2014,1,2014-01-01,89715,0,89715
Sunshine Coast,2014,2,2014-02-01,58894,0,58894
Sunshine Coast,2014,3,2014-03-01,70758,0,70758
Sunshine Coast,2014,4,2014-04-01,76433,0,76433
Sunshine Coast,2014,5,2014-05-01,62094,0,62094
Sunshine Coast,2014,6,2014-06-01,62509,461,62970
Sunshine Coast,2014,7,2014-07-01,74241,2711,76952
Sunshine Coast,2014,8,2014-08-01,64748,2564,67312
Sunshine Coast,2014,9,2014-09-01,75793,2444,78237
Sunshine Coast,2014,10,2014-10-01,80669,2068,82737
Sunshine Coast,2014,11,2014-11-01,72331,0,72331
Sunshine Coast,2014,12,2014-12-01,73915,0,73915
Sunshine Coast,2015,1,2015-01-01,79938,0,79938
Sunshine Coast,2015,2,2015-02-01,52182,0,52182
Sunshine Coast,2015,3,2015-03-01,64444,0,64444
Sunshine Coast,2015,4,2015-04-01,74845,0,74845
Sunshine Coast,2015,5,2015-05-01,59923,0,59923
Sunshine Coast,2015,6,2015-06-01,64649,441,65090
Sunshine Coast,2015,7,2015-07-01,79502,3152,82654
Sunshine Coast,2015,8,2015-08-01,74155,3195,77350
Sunshine Coast,2015,9,2015-09-01,85823,3236,89059
Sunshine Coast,2015,10,2015-10-01,88371,2237,90608
Sunshine Coast,2015,11,2015-11-01,79122,0,79122
Sunshine Coast,2015,12,2015-12-01,85152,1337,86489
Sunshine Coast,2016,1,2016-01-01,89602,2188,91790
Sunshine Coast,2016,2,2016-02-01,63086,1590,64676
Sunshine Coast,2016,3,2016-03-01,75739,0,75739
Sunshine Coast,2016,4,2016-04-01,81708,0,81708
Sunshine Coast,2016,5,2016-05-01,68480,0,68480
Sunshine Coast,2016,6,2016-06-01,70444,0,70444
Sunshine Coast,2016,7,2016-07-01,91050,3546,94596
Sunshine Coast,2016,8,2016-08-01,76876,3252,80128
Sunshine Coast,2016,9,2016-09-01,90690,3640,94330
Sunshine Coast,2016,10,2016-10-01,96568,3290,99858
Sunshine Coast,2016,11,2016-11-01,91086,0,91086
Sunshine Coast,2016,12,2016-12-01,97423,0,97423
Sunshine Coast,2017,1,2017-01-01,103183,0,103183
Sunshine Coast,2017,2,2017-02-01,69264,0,69264
Sunshine Coast,2017,3,2017-03-01,81035,0,81035
Sunshine Coast,2017,4,2017-04-01,100871,0,100871
Sunshine Coast,2017,5,2017-05-01,74861,0,74861
Sunshine Coast,2017,6,2017-06-01,74819,0,74819
Sunshine Coast,2017,7,2017-07-01,100550,3303,103853
Sunshine Coast,2017,8,2017-08-01,85528,3239,88767
Sunshine Coast,2017,9,2017-09-01,100873,3570,104443
Sunshine Coast,2017,10,2017-10-01,110578,3607,114185
Sunshine Coast,2017,11,2017-11-01,101006,0,101006
Sunshine Coast,2017,12,2017-12-01,110397,0,110397
Sunshine Coast,2018,1,2018-01-01,119654,0,119654
Sunshine Coast,2018,2,2018-02-01,80087,0,80087
Sunshine Coast,2018,3,2018-03-01,95146,0,95146
Sunshine Coast,2018,4,2018-04-01,103331,0,103331
Sunshine Coast,2018,5,2018-05-01,84546,0,84546
Sunshine Coast,2018,6,2018-06-01,83473,0,83473
Sunshine Coast,2018,7,2018-07-01,109626,3323,112949
Sunshine Coast,2018,8,2018-08-01,103119,4166,107285
Sunshine Coast,2018,9,2018-09-01,108273,3645,111918
Sunshine Coast,2018,10,2018-10-01,114720,3169,117889
Sunshine Coast,2018,11,2018-11-01,106534,0,106534
Sunshine Coast,2018,12,2018-12-01,112093,0,112093
Sunshine Coast,2019,1,2019-01-01,117350,0,117350
Sunshine Coast,2019,2,2019-02-01,78736,0,78736
Sydney,2009,1,2009-01-01,1847513,996457,2843970
Sydney,2009,2,2009-02-01,1673605,801924,2475529
Sydney,2009,3,2009-03-01,1874832,821693,2696525
Sydney,2009,4,2009-04-01,1841321,870622,2711943
Sydney,2009,5,2009-05-01,1718158,759410,2477568
Sydney,2009,6,2009-06-01,1648040,767888,2415928
Sydney,2009,7,2009-07-01,1891155,941348,2832503
Sydney,2009,8,2009-08-01,1882043,864145,2746188
Sydney,2009,9,2009-09-01,1912421,879689,2792110
Sydney,2009,10,2009-10-01,2097780,975493,3073273
Sydney,2009,11,2009-11-01,2002516,894245,2896761
Sydney,2009,12,2009-12-01,1973388,1062356,3035744
Sydney,2010,1,2010-01-01,1892143,1110678,3002821
Sydney,2010,2,2010-02-01,1877359,899053,2776412
Sydney,2010,3,2010-03-01,2051486,926343,2977829
Sydney,2010,4,2010-04-01,1998206,886880,2885086
Sydney,2010,5,2010-05-01,1904291,803140,2707431
Sydney,2010,6,2010-06-01,1868120,867125,2735245
Sydney,2010,7,2010-07-01,2082684,1015800,3098484
Sydney,2010,8,2010-08-01,2033255,928432,2961687
Sydney,2010,9,2010-09-01,2059553,962454,3022007
Sydney,2010,10,2010-10-01,2189947,1008887,3198834
Sydney,2010,11,2010-11-01,2108590,944323,3052913
Sydney,2010,12,2010-12-01,2129048,1102422,3231470
Sydney,2011,1,2011-01-01,1987061,1159333,3146394
Sydney,2011,2,2011-02-01,1854859,916286,2771145
Sydney,2011,3,2011-03-01,2073799,902945,2976744
Sydney,2011,4,2011-04-01,2039393,966189,3005582
Sydney,2011,5,2011-05-01,1948541,852753,2801294
Sydney,2011,6,2011-06-01,1807246,884489,2691735
Sydney,2011,7,2011-07-01,2064177,1040159,3104336
Sydney,2011,8,2011-08-01,2004177,938127,2942304
Sydney,2011,9,2011-09-01,2009250,994485,3003735
Sydney,2011,10,2011-10-01,2059808,1030429,3090237
Sydney,2011,11,2011-11-01,2043114,952162,2995276
Sydney,2011,12,2011-12-01,2033926,1111225,3145151
Sydney,2012,1,2012-01-01,1971282,1180898,3152180
Sydney,2012,2,2012-02-01,1854942,940980,2795922
Sydney,2012,3,2012-03-01,2076967,972317,3049284
Sydney,2012,4,2012-04-01,2004321,1001330,3005651
Sydney,2012,5,2012-05-01,1957081,876247,2833328
Sydney,2012,6,2012-06-01,1890449,978946,2869395
Sydney,2012,7,2012-07-01,2114585,1076643,3191228
Sydney,2012,8,2012-08-01,2101971,1004945,3106916
Sydney,2012,9,2012-09-01,2123520,1056072,3179592
Sydney,2012,10,2012-10-01,2218802,1063489,3282291
Sydney,2012,11,2012-11-01,2192255,1025650,3217905
Sydney,2012,12,2012-12-01,2132702,1191676,3324378
Sydney,2013,1,2013-01-01,2062182,1210566,3272748
Sydney,2013,2,2013-02-01,1878746,974278,2853024
Sydney,2013,3,2013-03-01,2114483,1040515,3154998
Sydney,2013,4,2013-04-01,2103360,1028008,3131368
Sydney,2013,5,2013-05-01,1995550,936254,2931804
Sydney,2013,6,2013-06-01,1946797,1009456,2956253
Sydney,2013,7,2013-07-01,2203768,1139675,3343443
Sydney,2013,8,2013-08-01,2134712,1065538,3200250
Sydney,2013,9,2013-09-01,2103628,1097430,3201058
Sydney,2013,10,2013-10-01,2294181,1108398,3402579
Sydney,2013,11,2013-11-01,2169189,1073009,3242198
Sydney,2013,12,2013-12-01,2210065,1250758,3460823
Sydney,2014,1,2014-01-01,2148823,1306985,3455808
Sydney,2014,2,2014-02-01,1919917,1037233,2957150
Sydney,2014,3,2014-03-01,2140302,1044328,3184630
Sydney,2014,4,2014-04-01,2101306,1093236,3194542
Sydney,2014,5,2014-05-01,2019327,992357,3011684
Sydney,2014,6,2014-06-01,1945647,1029492,2975139
Sydney,2014,7,2014-07-01,2178146,1142090,3320236
Sydney,2014,8,2014-08-01,2128691,1076431,3205122
Sydney,2014,9,2014-09-01,2127562,1089560,3217122
Sydney,2014,10,2014-10-01,2347061,1135801,3482862
Sydney,2014,11,2014-11-01,2171234,1088600,3259834
Sydney,2014,12,2014-12-01,2189091,1279722,3468813
Sydney,2015,1,2015-01-01,2086423,1326387,3412810
Sydney,2015,2,2015-02-01,1943694,1066363,3010057
Sydney,2015,3,2015-03-01,2200850,1136718,3337568
Sydney,2015,4,2015-04-01,2114810,1099065,3213875
Sydney,2015,5,2015-05-01,2046769,1007863,3054632
Sydney,2015,6,2015-06-01,1979017,1060056,3039073
Sydney,2015,7,2015-07-01,2273885,1210977,3484862
Sydney,2015,8,2015-08-01,2145995,1120885,3266880
Sydney,2015,9,2015-09-01,2197135,1152403,3349538
Sydney,2015,10,2015-10-01,2342707,1191437,3534144
Sydney,2015,11,2015-11-01,2262498,1150341,3412839
Sydney,2015,12,2015-12-01,2303836,1388733,3692569
Sydney,2016,1,2016-01-01,2218150,1457786,3675936
Sydney,2016,2,2016-02-01,2111123,1204556,3315679
Sydney,2016,3,2016-03-01,2298486,1226541,3525027
Sydney,2016,4,2016-04-01,2226650,1214946,3441596
Sydney,2016,5,2016-05-01,2127391,1082798,3210189
Sydney,2016,6,2016-06-01,2055379,1140791,3196170
Sydney,2016,7,2016-07-01,2332285,1347109,3679394
Sydney,2016,8,2016-08-01,2209052,1210752,3419804
Sydney,2016,9,2016-09-01,2285326,1247507,3532833
Sydney,2016,10,2016-10-01,2377514,1281541,3659055
Sydney,2016,11,2016-11-01,2337440,1228753,3566193
Sydney,2016,12,2016-12-01,2327148,1468897,3796045
Sydney,2017,1,2017-01-01,2255527,1559969,3815496
Sydney,2017,2,2017-02-01,2058044,1225869,3283913
Sydney,2017,3,2017-03-01,2330826,1243785,3574611
Sydney,2017,4,2017-04-01,2243073,1346092,3589165
Sydney,2017,5,2017-05-01,2181077,1156617,3337694
Sydney,2017,6,2017-06-01,2117148,1242871,3360019
Sydney,2017,7,2017-07-01,2368234,1423033,3791267
Sydney,2017,8,2017-08-01,2236341,1300543,3536884
Sydney,2017,9,2017-09-01,2269844,1327350,3597194
Sydney,2017,10,2017-10-01,2444126,1345502,3789628
Sydney,2017,11,2017-11-01,2410803,1311556,3722359
Sydney,2017,12,2017-12-01,2376831,1554999,3931830
Sydney,2018,1,2018-01-01,2295333,1586333,3881666
Sydney,2018,2,2018-02-01,2137861,1314012,3451873
Sydney,2018,3,2018-03-01,2412959,1369182,3782141
Sydney,2018,4,2018-04-01,2314158,1373416,3687574
Sydney,2018,5,2018-05-01,2209018,1229871,3438889
Sydney,2018,6,2018-06-01,2128329,1295198,3423527
Sydney,2018,7,2018-07-01,2402625,1489983,3892608
Sydney,2018,8,2018-08-01,2326064,1362107,3688171
Sydney,2018,9,2018-09-01,2259795,1357595,3617390
Sydney,2018,10,2018-10-01,2482712,1436293,3919005
Sydney,2018,11,2018-11-01,2381598,1347275,3728873
Sydney,2018,12,2018-12-01,2316821,1601220,3918041
Sydney,2019,1,2019-01-01,2289327,1656401,3945728
Sydney,2019,2,2019-02-01,2082995,1320912,3403907
Townsville,2009,1,2009-01-01,106599,0,106599
Townsville,2009,2,2009-02-01,94011,0,94011
Townsville,2009,3,2009-03-01,113426,0,113426
Townsville,2009,4,2009-04-01,121841,0,121841
Townsville,2009,5,2009-05-01,128393,0,128393
Townsville,2009,6,2009-06-01,126795,0,126795
Townsville,2009,7,2009-07-01,143254,0,143254
Townsville,2009,8,2009-08-01,133406,0,133406
Townsville,2009,9,2009-09-01,129884,0,129884
Townsville,2009,10,2009-10-01,133483,0,133483
Townsville,2009,11,2009-11-01,125668,0,125668
Townsville,2009,12,2009-12-01,125470,0,125470
Townsville,2010,1,2010-01-01,111777,0,111777
Townsville,2010,2,2010-02-01,108963,0,108963
Townsville,2010,3,2010-03-01,120645,0,120645
Townsville,2010,4,2010-04-01,125738,0,125738
Townsville,2010,5,2010-05-01,126423,0,126423
Townsville,2010,6,2010-06-01,133658,0,133658
Townsville,2010,7,2010-07-01,148723,0,148723
Townsville,2010,8,2010-08-01,146100,0,146100
Townsville,2010,9,2010-09-01,144793,0,144793
Townsville,2010,10,2010-10-01,146069,0,146069
Townsville,2010,11,2010-11-01,132767,0,132767
Townsville,2010,12,2010-12-01,143094,1314,144408
Townsville,2011,1,2011-01-01,119392,1942,121334
Townsville,2011,2,2011-02-01,103941,1160,105101
Townsville,2011,3,2011-03-01,133861,1154,135015
Townsville,2011,4,2011-04-01,133258,1004,134262
Townsville,2011,5,2011-05-01,136110,845,136955
Townsville,2011,6,2011-06-01,134134,754,134888
Townsville,2011,7,2011-07-01,150716,1125,151841
Townsville,2011,8,2011-08-01,142518,740,143258
Townsville,2011,9,2011-09-01,143180,766,143946
Townsville,2011,10,2011-10-01,139427,102,139529
Townsville,2011,11,2011-11-01,133051,0,133051
Townsville,2011,12,2011-12-01,137703,0,137703
Townsville,2012,1,2012-01-01,119347,0,119347
Townsville,2012,2,2012-02-01,117506,0,117506
Townsville,2012,3,2012-03-01,132720,0,132720
Townsville,2012,4,2012-04-01,131782,0,131782
Townsville,2012,5,2012-05-01,137363,0,137363
Townsville,2012,6,2012-06-01,138525,0,138525
Townsville,2012,7,2012-07-01,147071,0,147071
Townsville,2012,8,2012-08-01,138717,0,138717
Townsville,2012,9,2012-09-01,136210,0,136210
Townsville,2012,10,2012-10-01,143314,0,143314
Townsville,2012,11,2012-11-01,133249,0,133249
Townsville,2012,12,2012-12-01,133934,0,133934
Townsville,2013,1,2013-01-01,118412,0,118412
Townsville,2013,2,2013-02-01,107619,0,107619
Townsville,2013,3,2013-03-01,123296,0,123296
Townsville,2013,4,2013-04-01,127312,0,127312
Townsville,2013,5,2013-05-01,128589,0,128589
Townsville,2013,6,2013-06-01,131996,0,131996
Townsville,2013,7,2013-07-01,148020,0,148020
Townsville,2013,8,2013-08-01,137315,0,137315
Townsville,2013,9,2013-09-01,137805,0,137805
Townsville,2013,10,2013-10-01,140343,0,140343
Townsville,2013,11,2013-11-01,120887,0,120887
Townsville,2013,12,2013-12-01,134985,0,134985
Townsville,2014,1,2014-01-01,112198,0,112198
Townsville,2014,2,2014-02-01,100711,0,100711
Townsville,2014,3,2014-03-01,115781,0,115781
Townsville,2014,4,2014-04-01,122260,0,122260
Townsville,2014,5,2014-05-01,123849,0,123849
Townsville,2014,6,2014-06-01,128778,0,128778
Townsville,2014,7,2014-07-01,142439,0,142439
Townsville,2014,8,2014-08-01,132001,0,132001
Townsville,2014,9,2014-09-01,134422,0,134422
Townsville,2014,10,2014-10-01,136139,0,136139
Townsville,2014,11,2014-11-01,117175,0,117175
Townsville,2014,12,2014-12-01,132088,0,132088
Townsville,2015,1,2015-01-01,111909,0,111909
Townsville,2015,2,2015-02-01,98439,0,98439
Townsville,2015,3,2015-03-01,117998,0,117998
Townsville,2015,4,2015-04-01,123844,0,123844
Townsville,2015,5,2015-05-01,124026,0,124026
Townsville,2015,6,2015-06-01,127577,0,127577
Townsville,2015,7,2015-07-01,145023,0,145023
Townsville,2015,8,2015-08-01,131085,0,131085
Townsville,2015,9,2015-09-01,134709,2809,137518
Townsville,2015,10,2015-10-01,135679,3535,139214
Townsville,2015,11,2015-11-01,121111,1229,122340
Townsville,2015,12,2015-12-01,128711,3550,132261
Townsville,2016,1,2016-01-01,111824,3234,115058
Townsville,2016,2,2016-02-01,98163,2722,100885
Townsville,2016,3,2016-03-01,117129,3159,120288
Townsville,2016,4,2016-04-01,120629,3021,123650
Townsville,2016,5,2016-05-01,125967,3618,129585
Townsville,2016,6,2016-06-01,129767,3707,133474
Townsville,2016,7,2016-07-01,142861,3892,146753
Townsville,2016,8,2016-08-01,130264,3409,133673
Townsville,2016,9,2016-09-01,134845,3703,138548
Townsville,2016,10,2016-10-01,129537,3895,133432
Townsville,2016,11,2016-11-01,118389,3286,121675
Townsville,2016,12,2016-12-01,128625,3833,132458
Townsville,2017,1,2017-01-01,111180,3847,115027
Townsville,2017,2,2017-02-01,96830,3271,100101
Townsville,2017,3,2017-03-01,115121,3235,118356
Townsville,2017,4,2017-04-01,126737,4282,131019
Townsville,2017,5,2017-05-01,122567,4324,126891
Townsville,2017,6,2017-06-01,132681,4229,136910
Townsville,2017,7,2017-07-01,150468,4909,155377
Townsville,2017,8,2017-08-01,140606,4604,145210
Townsville,2017,9,2017-09-01,139916,4565,144481
Townsville,2017,10,2017-10-01,139884,4378,144262
Townsville,2017,11,2017-11-01,128802,3369,132171
Townsville,2017,12,2017-12-01,136698,3522,140220
Townsville,2018,1,2018-01-01,120185,4606,124791
Townsville,2018,2,2018-02-01,104371,4320,108691
Townsville,2018,3,2018-03-01,135166,3099,138265
Townsville,2018,4,2018-04-01,127310,858,128168
Townsville,2018,5,2018-05-01,133949,547,134496
Townsville,2018,6,2018-06-01,130112,693,130805
Townsville,2018,7,2018-07-01,159435,808,160243
Townsville,2018,8,2018-08-01,146577,672,147249
Townsville,2018,9,2018-09-01,137187,584,137771
Townsville,2018,10,2018-10-01,140204,0,140204
Townsville,2018,11,2018-11-01,129096,0,129096
Townsville,2018,12,2018-12-01,130519,0,130519
Townsville,2019,1,2019-01-01,118189,0,118189
Townsville,2019,2,2019-02-01,100266,0,100266
All Australian Airports,2009,1,2009-01-01,8316460,2249424,10565884
All Australian Airports,2009,2,2009-02-01,7238300,1793147,9031447
All Australian Airports,2009,3,2009-03-01,8319008,1871540,10190548
All Australian Airports,2009,4,2009-04-01,8275542,1975608,10251150
All Australian Airports,2009,5,2009-05-01,7876608,1764508,9641116
All Australian Airports,2009,6,2009-06-01,7582058,1829895,9411953
All Australian Airports,2009,7,2009-07-01,8552960,2139351,10692311
All Australian Airports,2009,8,2009-08-01,8396528,1999799,10396327
All Australian Airports,2009,9,2009-09-01,8521298,2086767,10608065
All Australian Airports,2009,10,2009-10-01,8999378,2217762,11217140
All Australian Airports,2009,11,2009-11-01,8530380,2075908,10606288
All Australian Airports,2009,12,2009-12-01,8417658,2403191,10820849
All Australian Airports,2010,1,2010-01-01,8170184,2482669,10652853
All Australian Airports,2010,2,2010-02-01,7822194,2030127,9852321
All Australian Airports,2010,3,2010-03-01,8816840,2145529,10962369
All Australian Airports,2010,4,2010-04-01,8703608,2062773,10766381
All Australian Airports,2010,5,2010-05-01,8306804,1886099,10192903
All Australian Airports,2010,6,2010-06-01,8315806,2095679,10411485
All Australian Airports,2010,7,2010-07-01,9266286,2401136,11667422
All Australian Airports,2010,8,2010-08-01,9038618,2213745,11252363
All Australian Airports,2010,9,2010-09-01,9226780,2316363,11543143
All Australian Airports,2010,10,2010-10-01,9663202,2373199,12036401
All Australian Airports,2010,11,2010-11-01,9196712,2205642,11402354
All Australian Airports,2010,12,2010-12-01,9383700,2577354,11961054
All Australian Airports,2011,1,2011-01-01,8774582,2709123,11483705
All Australian Airports,2011,2,2011-02-01,7845168,2120226,9965394
All Australian Airports,2011,3,2011-03-01,9069790,2111623,11181413
All Australian Airports,2011,4,2011-04-01,9049750,2285449,11335199
All Australian Airports,2011,5,2011-05-01,8756154,2079485,10835639
All Australian Airports,2011,6,2011-06-01,8188636,2155944,10344580
All Australian Airports,2011,7,2011-07-01,9368226,2531894,11900120
All Australian Airports,2011,8,2011-08-01,9099846,2308924,11408770
All Australian Airports,2011,9,2011-09-01,9094122,2401935,11496057
All Australian Airports,2011,10,2011-10-01,9382632,2476335,11858967
All Australian Airports,2011,11,2011-11-01,9154462,2302972,11457434
All Australian Airports,2011,12,2011-12-01,9110428,2671099,11781527
All Australian Airports,2012,1,2012-01-01,8944232,2803526,11747758
All Australian Airports,2012,2,2012-02-01,8242428,2220767,10463195
All Australian Airports,2012,3,2012-03-01,9305268,2325361,11630629
All Australian Airports,2012,4,2012-04-01,9057790,2379244,11437034
All Australian Airports,2012,5,2012-05-01,8919608,2099103,11018711
All Australian Airports,2012,6,2012-06-01,8710602,2361188,11071790
All Australian Airports,2012,7,2012-07-01,9676804,2595183,12271987
All Australian Airports,2012,8,2012-08-01,9507058,2418677,11925735
All Australian Airports,2012,9,2012-09-01,9574306,2532916,12107222
All Australian Airports,2012,10,2012-10-01,10079832,2572716,12652548
All Australian Airports,2012,11,2012-11-01,9795878,2450674,12246552
All Australian Airports,2012,12,2012-12-01,9490652,2849637,12340289
All Australian Airports,2013,1,2013-01-01,9255974,2887496,12143470
All Australian Airports,2013,2,2013-02-01,8256730,2313309,10570039
All Australian Airports,2013,3,2013-03-01,9448022,2497251,11945273
All Australian Airports,2013,4,2013-04-01,9457206,2449934,11907140
All Australian Airports,2013,5,2013-05-01,9006082,2274189,11280271
All Australian Airports,2013,6,2013-06-01,8869878,2467916,11337794
All Australian Airports,2013,7,2013-07-01,10104312,2795406,12899718
All Australian Airports,2013,8,2013-08-01,9690888,2644290,12335178
All Australian Airports,2013,9,2013-09-01,9577030,2680985,12258015
All Australian Airports,2013,10,2013-10-01,10359050,2709608,13068658
All Australian Airports,2013,11,2013-11-01,9612210,2553483,12165693
All Australian Airports,2013,12,2013-12-01,9853546,3070649,12924195
All Australian Airports,2014,1,2014-01-01,9580584,3201609,12782193
All Australian Airports,2014,2,2014-02-01,8413870,2490343,10904213
All Australian Airports,2014,3,2014-03-01,9489838,2531778,12021616
All Australian Airports,2014,4,2014-04-01,9514764,2709932,12224696
All Australian Airports,2014,5,2014-05-01,9057492,2448609,11506101
All Australian Airports,2014,6,2014-06-01,8894146,2585441,11479587
All Australian Airports,2014,7,2014-07-01,9996582,2957222,12953804
All Australian Airports,2014,8,2014-08-01,9592076,2744275,12336351
All Australian Airports,2014,9,2014-09-01,9610186,2781028,12391214
All Australian Airports,2014,10,2014-10-01,10477524,2854559,13332083
All Australian Airports,2014,11,2014-11-01,9534382,2668537,12202919
All Australian Airports,2014,12,2014-12-01,9771498,3159755,12931253
All Australian Airports,2015,1,2015-01-01,9261524,3282915,12544439
All Australian Airports,2015,2,2015-02-01,8366126,2651565,11017691
All Australian Airports,2015,3,2015-03-01,9584080,2802213,12386293
All Australian Airports,2015,4,2015-04-01,9444866,2746515,12191381
All Australian Airports,2015,5,2015-05-01,9003498,2527461,11530959
All Australian Airports,2015,6,2015-06-01,8865434,2688592,11554026
All Australian Airports,2015,7,2015-07-01,10226320,3089421,13315741
All Australian Airports,2015,8,2015-08-01,9534626,2870955,12405581
All Australian Airports,2015,9,2015-09-01,9733756,2933459,12667215
All Australian Airports,2015,10,2015-10-01,10317152,3022122,13339274
All Australian Airports,2015,11,2015-11-01,9835410,2823632,12659042
All Australian Airports,2015,12,2015-12-01,10056560,3427799,13484359
All Australian Airports,2016,1,2016-01-01,9585532,3560271,13145803
All Australian Airports,2016,2,2016-02-01,8881300,2935682,11816982
All Australian Airports,2016,3,2016-03-01,9897144,3009317,12906461
All Australian Airports,2016,4,2016-04-01,9627012,2959262,12586274
All Australian Airports,2016,5,2016-05-01,9275816,2690863,11966679
All Australian Airports,2016,6,2016-06-01,9157288,2905948,12063236
All Australian Airports,2016,7,2016-07-01,10312870,3407850,13720720
All Australian Airports,2016,8,2016-08-01,9713032,3063012,12776044
All Australian Airports,2016,9,2016-09-01,10058464,3175613,13234077
All Australian Airports,2016,10,2016-10-01,10420118,3225758,13645876
All Australian Airports,2016,11,2016-11-01,10043856,3025559,13069415
All Australian Airports,2016,12,2016-12-01,10216170,3657618,13873788
All Australian Airports,2017,1,2017-01-01,9887058,3802113,13689171
All Australian Airports,2017,2,2017-02-01,8653900,2970635,11624535
All Australian Airports,2017,3,2017-03-01,9942442,3059339,13001781
All Australian Airports,2017,4,2017-04-01,9815284,3307826,13123110
All Australian Airports,2017,5,2017-05-01,9423080,2871230,12294310
All Australian Airports,2017,6,2017-06-01,9322072,3094393,12416465
All Australian Airports,2017,7,2017-07-01,10537100,3540914,14078014
All Australian Airports,2017,8,2017-08-01,9893950,3250087,13144037
All Australian Airports,2017,9,2017-09-01,10072534,3330398,13402932
All Australian Airports,2017,10,2017-10-01,10767902,3369928,14137830
All Australian Airports,2017,11,2017-11-01,10361670,3191909,13553579
All Australian Airports,2017,12,2017-12-01,10420156,3826935,14247091
All Australian Airports,2018,1,2018-01-01,10087998,3885401,13973399
All Australian Airports,2018,2,2018-02-01,9009336,3187620,12196956
All Australian Airports,2018,3,2018-03-01,10381216,3370279,13751495
All Australian Airports,2018,4,2018-04-01,10079632,3362133,13441765
All Australian Airports,2018,5,2018-05-01,9645110,3026652,12671762
All Australian Airports,2018,6,2018-06-01,9351292,3276906,12628198
All Australian Airports,2018,7,2018-07-01,10794498,3711115,14505613
All Australian Airports,2018,8,2018-08-01,10286610,3469473,13756083
All Australian Airports,2018,9,2018-09-01,10080778,3462722,13543500
All Australian Airports,2018,10,2018-10-01,10904946,3547757,14452703
All Australian Airports,2018,11,2018-11-01,10372794,3324676,13697470
All Australian Airports,2018,12,2018-12-01,10203362,3950579,14153941
All Australian Airports,2019,1,2019-01-01,10054672,4073072,14127744
All Australian Airports,2019,2,2019-02-01,8926364,3256808,12183172