Airport,Year,Month,Date,Domestic_Passengers,International_Passengers,Total_Passengers
Adelaide,2009,1,1/1/09,517632,45113,562745
Adelaide,2009,2,1/2/09,466920,36184,503104
Adelaide,2009,3,1/3/09,565261,37620,602881
Adelaide,2009,4,1/4/09,555522,41440,596962
Adelaide,2009,5,1/5/09,517203,36406,553609
Adelaide,2009,6,1/6/09,484873,37129,522002
Adelaide,2009,7,1/7/09,542166,45352,587518
Adelaide,2009,8,1/8/09,538835,40627,579462
Adelaide,2009,9,1/9/09,531861,44738,576599
Adelaide,2009,10,1/10/09,561466,47040,608506
Adelaide,2009,11,1/11/09,531518,43449,574967
Adelaide,2009,12,1/12/09,527091,46301,573392
Adelaide,2010,1,1/1/10,519063,48805,567868
Adelaide,2010,2,1/2/10,499819,38282,538101
Adelaide,2010,3,1/3/10,586946,42695,629641
Adelaide,2010,4,1/4/10,586710,45420,632130
Adelaide,2010,5,1/5/10,541978,39331,581309
Adelaide,2010,6,1/6/10,524575,41441,566016
Adelaide,2010,7,1/7/10,590676,47178,637854
Adelaide,2010,8,1/8/10,567307,43369,610676
Adelaide,2010,9,1/9/10,569972,45753,615725
Adelaide,2010,10,1/10/10,614845,46941,661786
Adelaide,2010,11,1/11/10,568388,44046,612434
Adelaide,2010,12,1/12/10,587933,49131,637064
Adelaide,2011,1,1/1/11,549241,49494,598735
Adelaide,2011,2,1/2/11,500762,40101,540863
Adelaide,2011,3,1/3/11,589089,43138,632227
Adelaide,2011,4,1/4/11,569555,48782,618337
Adelaide,2011,5,1/5/11,548098,45314,593412
Adelaide,2011,6,1/6/11,475053,44600,519653
Adelaide,2011,7,1/7/11,550818,53391,604209
Adelaide,2011,8,1/8/11,526160,49977,576137
Adelaide,2011,9,1/9/11,523982,51072,575054
Adelaide,2011,10,1/10/11,551110,52025,603135
Adelaide,2011,11,1/11/11,531539,47928,579467
Adelaide,2011,12,1/12/11,522927,57251,580178
Adelaide,2012,1,1/1/12,519484,61737,581221
Adelaide,2012,2,1/2/12,491820,47477,539297
Adelaide,2012,3,1/3/12,559334,51632,610966
Adelaide,2012,4,1/4/12,531241,51716,582957
Adelaide,2012,5,1/5/12,526113,45236,571349
Adelaide,2012,6,1/6/12,493715,49307,543022
Adelaide,2012,7,1/7/12,545554,56268,601822
Adelaide,2012,8,1/8/12,528411,49357,577768
Adelaide,2012,9,1/9/12,540478,55038,595516
Adelaide,2012,10,1/10/12,568726,53692,622418
Adelaide,2012,11,1/11/12,568625,58625,627250
Adelaide,2012,12,1/12/12,543314,69992,613306
Adelaide,2013,1,1/1/13,528626,70248,598874
Adelaide,2013,2,1/2/13,482351,57932,540283
Adelaide,2013,3,1/3/13,566943,61224,628167
Adelaide,2013,4,1/4/13,567813,63566,631379
Adelaide,2013,5,1/5/13,523424,54908,578332
Adelaide,2013,6,1/6/13,496963,58619,555582
Adelaide,2013,7,1/7/13,575913,72764,648677
Adelaide,2013,8,1/8/13,539644,64337,603981
Adelaide,2013,9,1/9/13,545307,69573,614880
Adelaide,2013,10,1/10/13,607419,68521,675940
Adelaide,2013,11,1/11/13,558869,68082,626951
Adelaide,2013,12,1/12/13,581017,89811,670828
Adelaide,2014,1,1/1/14,556572,95325,651897
Adelaide,2014,2,1/2/14,504053,69804,573857
Adelaide,2014,3,1/3/14,581303,71212,652515
Adelaide,2014,4,1/4/14,568388,82087,650475
Adelaide,2014,5,1/5/14,536398,74345,610743
Adelaide,2014,6,1/6/14,515982,80662,596644
Adelaide,2014,7,1/7/14,573743,95610,669353
Adelaide,2014,8,1/8/14,561222,80809,642031
Adelaide,2014,9,1/9/14,557453,80741,638194
Adelaide,2014,10,1/10/14,630681,79485,710166
Adelaide,2014,11,1/11/14,558777,68976,627753
Adelaide,2014,12,1/12/14,587027,88209,675236
Adelaide,2015,1,1/1/15,544328,91141,635469
Adelaide,2015,2,1/2/15,503965,69039,573004
Adelaide,2015,3,1/3/15,585173,70810,655983
Adelaide,2015,4,1/4/15,586146,70469,656615
Adelaide,2015,5,1/5/15,542748,67667,610415
Adelaide,2015,6,1/6/15,505461,70521,575982
Adelaide,2015,7,1/7/15,598092,77188,675280
Adelaide,2015,8,1/8/15,560021,70699,630720
Adelaide,2015,9,1/9/15,563095,71100,634195
Adelaide,2015,10,1/10/15,620527,72389,692916
Adelaide,2015,11,1/11/15,590588,60841,651429
Adelaide,2015,12,1/12/15,599637,79524,679161
Adelaide,2016,1,1/1/16,566662,84427,651089
Adelaide,2016,2,1/2/16,526882,64796,591678
Adelaide,2016,3,1/3/16,604594,66425,671019
Adelaide,2016,4,1/4/16,594187,67722,661909
Adelaide,2016,5,1/5/16,563975,69012,632987
Adelaide,2016,6,1/6/16,532273,73079,605352
Adelaide,2016,7,1/7/16,607954,90683,698637
Adelaide,2016,8,1/8/16,564253,79247,643500
Adelaide,2016,9,1/9/16,582329,83152,665481
Adelaide,2016,10,1/10/16,636290,81749,718039
Adelaide,2016,11,1/11/16,610621,71003,681624
Adelaide,2016,12,1/12/16,605974,92884,698858
Adelaide,2017,1,1/1/17,587837,94277,682114
Adelaide,2017,2,1/2/17,523949,68611,592560
Adelaide,2017,3,1/3/17,621085,71109,692194
Adelaide,2017,4,1/4/17,591139,73812,664951
Adelaide,2017,5,1/5/17,570882,71121,642003
Adelaide,2017,6,1/6/17,546124,73295,619419
Adelaide,2017,7,1/7/17,619108,89712,708820
Adelaide,2017,8,1/8/17,574943,82584,657527
Adelaide,2017,9,1/9/17,591552,87033,678585
Adelaide,2017,10,1/10/17,653560,82620,736180
Adelaide,2017,11,1/11/17,627919,74418,702337
Adelaide,2017,12,1/12/17,640861,94383,735244
Adelaide,2018,1,1/1/18,604865,105584,710449
Adelaide,2018,2,1/2/18,547363,73693,621056
Adelaide,2018,3,1/3/18,638977,77493,716470
Adelaide,2018,4,1/4/18,627977,77949,705926
Adelaide,2018,5,1/5/18,589510,74528,664038
Adelaide,2018,6,1/6/18,558369,78573,636942
Adelaide,2018,7,1/7/18,638329,91266,729595
Adelaide,2018,8,1/8/18,602934,87573,690507
Adelaide,2018,9,1/9/18,601330,89394,690724
Adelaide,2018,10,1/10/18,657363,88105,745468
Adelaide,2018,11,1/11/18,633974,82278,716252
Adelaide,2018,12,1/12/18,619350,99525,718875
Adelaide,2019,1,1/1/19,592951,107476,700427
Adelaide,2019,2,1/2/19,551355,80250,631605
Alice Springs,2009,1,1/1/09,52040,0,52040
Alice Springs,2009,2,1/2/09,45340,0,45340
Alice Springs,2009,3,1/3/09,55685,0,55685
Alice Springs,2009,4,1/4/09,57116,0,57116
Alice Springs,2009,5,1/5/09,54641,0,54641
Alice Springs,2009,6,1/6/09,54204,0,54204
Alice Springs,2009,7,1/7/09,63630,0,63630
Alice Springs,2009,8,1/8/09,62136,0,62136
Alice Springs,2009,9,1/9/09,59804,0,59804
Alice Springs,2009,10,1/10/09,63045,0,63045
Alice Springs,2009,11,1/11/09,56109,0,56109
Alice Springs,2009,12,1/12/09,51151,0,51151
Alice Springs,2010,1,1/1/10,51424,0,51424
Alice Springs,2010,2,1/2/10,47884,0,47884
Alice Springs,2010,3,1/3/10,58601,0,58601
Alice Springs,2010,4,1/4/10,58508,0,58508
Alice Springs,2010,5,1/5/10,54695,0,54695
Alice Springs,2010,6,1/6/10,54308,0,54308
Alice Springs,2010,7,1/7/10,61986,0,61986
Alice Springs,2010,8,1/8/10,60620,0,60620
Alice Springs,2010,9,1/9/10,58603,0,58603
Alice Springs,2010,10,1/10/10,60874,0,60874
Alice Springs,2010,11,1/11/10,53219,0,53219
Alice Springs,2010,12,1/12/10,48122,0,48122
Alice Springs,2011,1,1/1/11,47486,0,47486
Alice Springs,2011,2,1/2/11,43828,0,43828
Alice Springs,2011,3,1/3/11,50398,0,50398
Alice Springs,2011,4,1/4/11,55081,0,55081
Alice Springs,2011,5,1/5/11,50605,0,50605
Alice Springs,2011,6,1/6/11,49697,0,49697
Alice Springs,2011,7,1/7/11,55314,0,55314
Alice Springs,2011,8,1/8/11,51690,0,51690
Alice Springs,2011,9,1/9/11,47709,0,47709
Alice Springs,2011,10,1/10/11,52883,0,52883
Alice Springs,2011,11,1/11/11,49003,0,49003
Alice Springs,2011,12,1/12/11,45055,0,45055
Alice Springs,2012,1,1/1/12,43218,0,43218
Alice Springs,2012,2,1/2/12,41645,0,41645
Alice Springs,2012,3,1/3/12,47137,0,47137
Alice Springs,2012,4,1/4/12,47511,0,47511
Alice Springs,2012,5,1/5/12,45930,0,45930
Alice Springs,2012,6,1/6/12,48225,0,48225
Alice Springs,2012,7,1/7/12,55120,0,55120
Alice Springs,2012,8,1/8/12,52472,0,52472
Alice Springs,2012,9,1/9/12,51409,0,51409
Alice Springs,2012,10,1/10/12,52987,0,52987
Alice Springs,2012,11,1/11/12,50249,0,50249
Alice Springs,2012,12,1/12/12,43849,0,43849
Alice Springs,2013,1,1/1/13,42504,0,42504
Alice Springs,2013,2,1/2/13,39108,0,39108
Alice Springs,2013,3,1/3/13,47342,0,47342
Alice Springs,2013,4,1/4/13,52892,0,52892
Alice Springs,2013,5,1/5/13,50160,0,50160
Alice Springs,2013,6,1/6/13,57670,0,57670
Alice Springs,2013,7,1/7/13,66751,0,66751
Alice Springs,2013,8,1/8/13,64279,0,64279
Alice Springs,2013,9,1/9/13,59611,0,59611
Alice Springs,2013,10,1/10/13,66304,0,66304
Alice Springs,2013,11,1/11/13,57429,0,57429
Alice Springs,2013,12,1/12/13,51195,0,51195
Alice Springs,2014,1,1/1/14,48329,0,48329
Alice Springs,2014,2,1/2/14,45421,0,45421
Alice Springs,2014,3,1/3/14,54122,0,54122
Alice Springs,2014,4,1/4/14,55995,0,55995
Alice Springs,2014,5,1/5/14,51841,0,51841
Alice Springs,2014,6,1/6/14,56256,0,56256
Alice Springs,2014,7,1/7/14,61763,0,61763
Alice Springs,2014,8,1/8/14,55759,0,55759
Alice Springs,2014,9,1/9/14,50835,0,50835
Alice Springs,2014,10,1/10/14,53955,0,53955
Alice Springs,2014,11,1/11/14,46199,0,46199
Alice Springs,2014,12,1/12/14,40594,0,40594
Alice Springs,2015,1,1/1/15,39279,0,39279
Alice Springs,2015,2,1/2/15,39325,0,39325
Alice Springs,2015,3,1/3/15,46890,0,46890
Alice Springs,2015,4,1/4/15,50420,0,50420
Alice Springs,2015,5,1/5/15,47291,0,47291
Alice Springs,2015,6,1/6/15,50431,0,50431
Alice Springs,2015,7,1/7/15,61048,0,61048
Alice Springs,2015,8,1/8/15,57699,0,57699
Alice Springs,2015,9,1/9/15,51752,0,51752
Alice Springs,2015,10,1/10/15,54772,0,54772
Alice Springs,2015,11,1/11/15,50498,0,50498
Alice Springs,2015,12,1/12/15,44105,0,44105
Alice Springs,2016,1,1/1/16,40548,0,40548
Alice Springs,2016,2,1/2/16,42192,0,42192
Alice Springs,2016,3,1/3/16,50308,0,50308
Alice Springs,2016,4,1/4/16,49934,0,49934
Alice Springs,2016,5,1/5/16,48299,0,48299
Alice Springs,2016,6,1/6/16,51670,0,51670
Alice Springs,2016,7,1/7/16,61281,0,61281
Alice Springs,2016,8,1/8/16,57448,0,57448
Alice Springs,2016,9,1/9/16,56261,0,56261
Alice Springs,2016,10,1/10/16,57953,0,57953
Alice Springs,2016,11,1/11/16,50336,0,50336
Alice Springs,2016,12,1/12/16,45944,0,45944
Alice Springs,2017,1,1/1/17,43990,0,43990
Alice Springs,2017,2,1/2/17,41130,0,41130
Alice Springs,2017,3,1/3/17,51969,0,51969
Alice Springs,2017,4,1/4/17,51915,0,51915
Alice Springs,2017,5,1/5/17,49198,0,49198
Alice Springs,2017,6,1/6/17,49761,0,49761
Alice Springs,2017,7,1/7/17,60269,0,60269
Alice Springs,2017,8,1/8/17,57954,0,57954
Alice Springs,2017,9,1/9/17,54335,0,54335
Alice Springs,2017,10,1/10/17,57338,0,57338
Alice Springs,2017,11,1/11/17,54558,0,54558
Alice Springs,2017,12,1/12/17,46076,0,46076
Alice Springs,2018,1,1/1/18,42375,0,42375
Alice Springs,2018,2,1/2/18,41299,0,41299
Alice Springs,2018,3,1/3/18,50973,0,50973
Alice Springs,2018,4,1/4/18,48800,0,48800
Alice Springs,2018,5,1/5/18,50014,0,50014
Alice Springs,2018,6,1/6/18,51067,0,51067
Alice Springs,2018,7,1/7/18,63687,0,63687
Alice Springs,2018,8,1/8/18,60177,0,60177
Alice Springs,2018,9,1/9/18,56698,0,56698
Alice Springs,2018,10,1/10/18,58191,0,58191
Alice Springs,2018,11,1/11/18,53006,0,53006
Alice Springs,2018,12,1/12/18,45125,0,45125
Alice Springs,2019,1,1/1/19,40274,0,40274
Alice Springs,2019,2,1/2/19,39096,0,39096
Ballina,2009,1,1/1/09,33053,0,33053
Ballina,2009,2,1/2/09,28388,0,28388
Ballina,2009,3,1/3/09,30284,0,30284
Ballina,2009,4,1/4/09,28611,0,28611
Ballina,2009,5,1/5/09,25987,0,25987
Ballina,2009,6,1/6/09,24260,0,24260
Ballina,2009,7,1/7/09,28074,0,28074
Ballina,2009,8,1/8/09,21206,0,21206
Ballina,2009,9,1/9/09,22373,0,22373
Ballina,2009,10,1/10/09,25573,0,25573
Ballina,2009,11,1/11/09,25227,0,25227
Ballina,2009,12,1/12/09,25278,0,25278
Ballina,2010,1,1/1/10,25493,0,25493
Ballina,2010,2,1/2/10,21832,0,21832
Ballina,2010,3,1/3/10,22620,0,22620
Ballina,2010,4,1/4/10,20989,0,20989
Ballina,2010,5,1/5/10,18641,0,18641
Ballina,2010,6,1/6/10,17078,0,17078
Ballina,2010,7,1/7/10,20393,0,20393
Ballina,2010,8,1/8/10,20988,0,20988
Ballina,2010,9,1/9/10,23167,0,23167
Ballina,2010,10,1/10/10,26030,0,26030
Ballina,2010,11,1/11/10,23095,0,23095
Ballina,2010,12,1/12/10,28563,0,28563
Ballina,2011,1,1/1/11,30918,0,30918
Ballina,2011,2,1/2/11,23605,0,23605
Ballina,2011,3,1/3/11,26052,0,26052
Ballina,2011,4,1/4/11,26201,0,26201
Ballina,2011,5,1/5/11,22065,0,22065
Ballina,2011,6,1/6/11,20245,0,20245
Ballina,2011,7,1/7/11,26161,0,26161
Ballina,2011,8,1/8/11,23560,0,23560
Ballina,2011,9,1/9/11,27135,0,27135
Ballina,2011,10,1/10/11,27650,0,27650
Ballina,2011,11,1/11/11,26149,0,26149
Ballina,2011,12,1/12/11,30758,0,30758
Ballina,2012,1,1/1/12,36030,0,36030
Ballina,2012,2,1/2/12,23942,0,23942
Ballina,2012,3,1/3/12,26249,0,26249
Ballina,2012,4,1/4/12,30077,0,30077
Ballina,2012,5,1/5/12,25097,0,25097
Ballina,2012,6,1/6/12,23341,0,23341
Ballina,2012,7,1/7/12,28479,0,28479
Ballina,2012,8,1/8/12,26407,0,26407
Ballina,2012,9,1/9/12,29738,0,29738
Ballina,2012,10,1/10/12,32174,0,32174
Ballina,2012,11,1/11/12,30169,0,30169
Ballina,2012,12,1/12/12,34308,0,34308
Ballina,2013,1,1/1/13,36651,0,36651
Ballina,2013,2,1/2/13,23098,0,23098
Ballina,2013,3,1/3/13,28128,0,28128
Ballina,2013,4,1/4/13,33902,0,33902
Ballina,2013,5,1/5/13,27718,0,27718
Ballina,2013,6,1/6/13,28291,0,28291
Ballina,2013,7,1/7/13,32257,0,32257
Ballina,2013,8,1/8/13,28312,0,28312
Ballina,2013,9,1/9/13,33967,0,33967
Ballina,2013,10,1/10/13,36928,0,36928
Ballina,2013,11,1/11/13,33262,0,33262
Ballina,2013,12,1/12/13,39833,0,39833
Ballina,2014,1,1/1/14,42349,0,42349
Ballina,2014,2,1/2/14,30092,0,30092
Ballina,2014,3,1/3/14,31747,0,31747
Ballina,2014,4,1/4/14,34182,0,34182
Ballina,2014,5,1/5/14,26762,0,26762
Ballina,2014,6,1/6/14,29314,0,29314
Ballina,2014,7,1/7/14,36122,0,36122
Ballina,2014,8,1/8/14,29907,0,29907
Ballina,2014,9,1/9/14,38883,0,38883
Ballina,2014,10,1/10/14,39256,0,39256
Ballina,2014,11,1/11/14,36277,0,36277
Ballina,2014,12,1/12/14,39304,0,39304
Ballina,2015,1,1/1/15,45436,0,45436
Ballina,2015,2,1/2/15,31445,0,31445
Ballina,2015,3,1/3/15,36086,0,36086
Ballina,2015,4,1/4/15,39772,0,39772
Ballina,2015,5,1/5/15,32153,0,32153
Ballina,2015,6,1/6/15,32385,0,32385
Ballina,2015,7,1/7/15,37513,0,37513
Ballina,2015,8,1/8/15,34180,0,34180
Ballina,2015,9,1/9/15,41641,0,41641
Ballina,2015,10,1/10/15,44079,0,44079
Ballina,2015,11,1/11/15,36701,0,36701
Ballina,2015,12,1/12/15,43507,0,43507
Ballina,2016,1,1/1/16,46906,0,46906
Ballina,2016,2,1/2/16,36594,0,36594
Ballina,2016,3,1/3/16,41689,0,41689
Ballina,2016,4,1/4/16,39998,0,39998
Ballina,2016,5,1/5/16,33665,0,33665
Ballina,2016,6,1/6/16,32591,0,32591
Ballina,2016,7,1/7/16,41880,0,41880
Ballina,2016,8,1/8/16,33840,0,33840
Ballina,2016,9,1/9/16,42665,0,42665
Ballina,2016,10,1/10/16,47435,0,47435
Ballina,2016,11,1/11/16,40335,0,40335
Ballina,2016,12,1/12/16,50325,0,50325
Ballina,2017,1,1/1/17,51901,0,51901
Ballina,2017,2,1/2/17,36897,0,36897
Ballina,2017,3,1/3/17,41070,0,41070
Ballina,2017,4,1/4/17,48490,0,48490
Ballina,2017,5,1/5/17,34202,0,34202
Ballina,2017,6,1/6/17,33759,0,33759
Ballina,2017,7,1/7/17,41496,0,41496
Ballina,2017,8,1/8/17,33847,0,33847
Ballina,2017,9,1/9/17,43990,0,43990
Ballina,2017,10,1/10/17,49595,0,49595
Ballina,2017,11,1/11/17,43054,0,43054
Ballina,2017,12,1/12/17,51278,0,51278
Ballina,2018,1,1/1/18,56662,0,56662
Ballina,2018,2,1/2/18,41626,0,41626
Ballina,2018,3,1/3/18,44689,0,44689
Ballina,2018,4,1/4/18,47430,0,47430
Ballina,2018,5,1/5/18,37390,0,37390
Ballina,2018,6,1/6/18,35717,0,35717
Ballina,2018,7,1/7/18,46180,0,46180
Ballina,2018,8,1/8/18,40123,0,40123
Ballina,2018,9,1/9/18,42966,0,42966
Ballina,2018,10,1/10/18,50893,0,50893
Ballina,2018,11,1/11/18,42984,0,42984
Ballina,2018,12,1/12/18,51520,0,51520
Ballina,2019,1,1/1/19,56463,0,56463
Ballina,2019,2,1/2/19,38167,0,38167
Brisbane,2009,1,1/1/09,1259327,377810,1637137
Brisbane,2009,2,1/2/09,1039265,300696,1339961
Brisbane,2009,3,1/3/09,1188065,314602,1502667
Brisbane,2009,4,1/4/09,1213113,334341,1547454
Brisbane,2009,5,1/5/09,1164256,303511,1467767
Brisbane,2009,6,1/6/09,1137727,324138,1461865
Brisbane,2009,7,1/7/09,1280886,372221,1653107
Brisbane,2009,8,1/8/09,1224013,352997,1577010
Brisbane,2009,9,1/9/09,1268630,358611,1627241
Brisbane,2009,10,1/10/09,1331349,363767,1695116
Brisbane,2009,11,1/11/09,1230897,335659,1566556
Brisbane,2009,12,1/12/09,1258396,378818,1637214
Brisbane,2010,1,1/1/10,1179826,376365,1556191
Brisbane,2010,2,1/2/10,1091254,307242,1398496
Brisbane,2010,3,1/3/10,1209259,330724,1539983
Brisbane,2010,4,1/4/10,1248593,328411,1577004
Brisbane,2010,5,1/5/10,1188698,307506,1496204
Brisbane,2010,6,1/6/10,1222414,350420,1572834
Brisbane,2010,7,1/7/10,1371029,408510,1779539
Brisbane,2010,8,1/8/10,1328818,373435,1702253
Brisbane,2010,9,1/9/10,1366862,380317,1747179
Brisbane,2010,10,1/10/10,1417246,376457,1793703
Brisbane,2010,11,1/11/10,1333772,346187,1679959
Brisbane,2010,12,1/12/10,1380381,396683,1777064
Brisbane,2011,1,1/1/11,1183437,396077,1579514
Brisbane,2011,2,1/2/11,1104756,307099,1411855
Brisbane,2011,3,1/3/11,1278582,310877,1589459
Brisbane,2011,4,1/4/11,1319238,354928,1674166
Brisbane,2011,5,1/5/11,1291627,334430,1626057
Brisbane,2011,6,1/6/11,1258224,355774,1613998
Brisbane,2011,7,1/7/11,1432602,421648,1854250
Brisbane,2011,8,1/8/11,1391452,385201,1776653
Brisbane,2011,9,1/9/11,1402267,391592,1793859
Brisbane,2011,10,1/10/11,1433784,400390,1834174
Brisbane,2011,11,1/11/11,1385030,364919,1749949
Brisbane,2011,12,1/12/11,1407984,421932,1829916
Brisbane,2012,1,1/1/12,1325342,417093,1742435
Brisbane,2012,2,1/2/12,1198554,322927,1521481
Brisbane,2012,3,1/3/12,1369715,340186,1709901
Brisbane,2012,4,1/4/12,1344510,362914,1707424
Brisbane,2012,5,1/5/12,1340158,320257,1660415
Brisbane,2012,6,1/6/12,1322216,370945,1693161
Brisbane,2012,7,1/7/12,1460227,405051,1865278
Brisbane,2012,8,1/8/12,1433116,374187,1807303
Brisbane,2012,9,1/9/12,1433166,388638,1821804
Brisbane,2012,10,1/10/12,1514062,393092,1907154
Brisbane,2012,11,1/11/12,1443020,359129,1802149
Brisbane,2012,12,1/12/12,1417263,416994,1834257
Brisbane,2013,1,1/1/13,1328867,403501,1732368
Brisbane,2013,2,1/2/13,1200869,332613,1533482
Brisbane,2013,3,1/3/13,1345737,364214,1709951
Brisbane,2013,4,1/4/13,1356396,357847,1714243
Brisbane,2013,5,1/5/13,1336670,339573,1676243
Brisbane,2013,6,1/6/13,1352353,388140,1740493
Brisbane,2013,7,1/7/13,1507955,425439,1933394
Brisbane,2013,8,1/8/13,1450518,412072,1862590
Brisbane,2013,9,1/9/13,1435802,412322,1848124
Brisbane,2013,10,1/10/13,1543562,413769,1957331
Brisbane,2013,11,1/11/13,1436535,376923,1813458
Brisbane,2013,12,1/12/13,1480433,442728,1923161
Brisbane,2014,1,1/1/14,1372181,441534,1813715
Brisbane,2014,2,1/2/14,1225101,352927,1578028
Brisbane,2014,3,1/3/14,1392456,362753,1755209
Brisbane,2014,4,1/4/14,1430220,406894,1837114
Brisbane,2014,5,1/5/14,1377109,367449,1744558
Brisbane,2014,6,1/6/14,1361433,393183,1754616
Brisbane,2014,7,1/7/14,1524165,455749,1979914
Brisbane,2014,8,1/8/14,1444799,436256,1881055
Brisbane,2014,9,1/9/14,1447030,431100,1878130
Brisbane,2014,10,1/10/14,1557772,438612,1996384
Brisbane,2014,11,1/11/14,1389179,405203,1794382
Brisbane,2014,12,1/12/14,1461391,473321,1934712
Brisbane,2015,1,1/1/15,1320230,476635,1796865
Brisbane,2015,2,1/2/15,1188499,390755,1579254
Brisbane,2015,3,1/3/15,1389419,415222,1804641
Brisbane,2015,4,1/4/15,1386700,418847,1805547
Brisbane,2015,5,1/5/15,1333554,387506,1721060
Brisbane,2015,6,1/6/15,1331860,414130,1745990
Brisbane,2015,7,1/7/15,1528339,463080,1991419
Brisbane,2015,8,1/8/15,1405051,450214,1855265
Brisbane,2015,9,1/9/15,1458446,449229,1907675
Brisbane,2015,10,1/10/15,1513535,458559,1972094
Brisbane,2015,11,1/11/15,1443719,413350,1857069
Brisbane,2015,12,1/12/15,1487622,500995,1988617
Brisbane,2016,1,1/1/16,1352527,506456,1858983
Brisbane,2016,2,1/2/16,1256169,408871,1665040
Brisbane,2016,3,1/3/16,1427777,427516,1855293
Brisbane,2016,4,1/4/16,1388552,419807,1808359
Brisbane,2016,5,1/5/16,1364794,393626,1758420
Brisbane,2016,6,1/6/16,1371519,430418,1801937
Brisbane,2016,7,1/7/16,1534178,491367,2025545
Brisbane,2016,8,1/8/16,1436244,460037,1896281
Brisbane,2016,9,1/9/16,1489897,472962,1962859
Brisbane,2016,10,1/10/16,1503029,483439,1986468
Brisbane,2016,11,1/11/16,1437942,438687,1876629
Brisbane,2016,12,1/12/16,1493224,516558,2009782
Brisbane,2017,1,1/1/17,1379205,523794,1902999
Brisbane,2017,2,1/2/17,1210431,412560,1622991
Brisbane,2017,3,1/3/17,1405729,439977,1845706
Brisbane,2017,4,1/4/17,1402313,476800,1879113
Brisbane,2017,5,1/5/17,1373532,427029,1800561
Brisbane,2017,6,1/6/17,1387399,456873,1844272
Brisbane,2017,7,1/7/17,1563106,509949,2073055
Brisbane,2017,8,1/8/17,1467515,483957,1951472
Brisbane,2017,9,1/9/17,1494470,494152,1988622
Brisbane,2017,10,1/10/17,1554142,494915,2049057
Brisbane,2017,11,1/11/17,1480566,457800,1938366
Brisbane,2017,12,1/12/17,1501518,551535,2053053
Brisbane,2018,1,1/1/18,1378329,545045,1923374
Brisbane,2018,2,1/2/18,1259538,443330,1702868
Brisbane,2018,3,1/3/18,1457485,487297,1944782
Brisbane,2018,4,1/4/18,1403739,490729,1894468
Brisbane,2018,5,1/5/18,1409964,456579,1866543
Brisbane,2018,6,1/6/18,1364609,487988,1852597
Brisbane,2018,7,1/7/18,1596729,552620,2149349
Brisbane,2018,8,1/8/18,1511547,534545,2046092
Brisbane,2018,9,1/9/18,1454622,528778,1983400
Brisbane,2018,10,1/10/18,1563298,532527,2095825
Brisbane,2018,11,1/11/18,1490280,478663,1968943
Brisbane,2018,12,1/12/18,1464389,574133,2038522
Brisbane,2019,1,1/1/19,1374505,585934,1960439
Brisbane,2019,2,1/2/19,1238654,459953,1698607
Cairns,2009,1,1/1/09,268382,35521,303903
Cairns,2009,2,1/2/09,209576,29586,239162
Cairns,2009,3,1/3/09,237098,35737,272835
Cairns,2009,4,1/4/09,255887,32110,287997
Cairns,2009,5,1/5/09,241607,29334,270941
Cairns,2009,6,1/6/09,247279,29244,276523
Cairns,2009,7,1/7/09,308760,34132,342892
Cairns,2009,8,1/8/09,290219,38767,328986
Cairns,2009,9,1/9/09,276497,37523,314020
Cairns,2009,10,1/10/09,290162,35753,325915
Cairns,2009,11,1/11/09,261622,32700,294322
Cairns,2009,12,1/12/09,246304,34396,280700
Cairns,2010,1,1/1/10,237782,33779,271561
Cairns,2010,2,1/2/10,222760,34452,257212
Cairns,2010,3,1/3/10,232256,36760,269016
Cairns,2010,4,1/4/10,249252,38048,287300
Cairns,2010,5,1/5/10,238779,34653,273432
Cairns,2010,6,1/6/10,268467,36417,304884
Cairns,2010,7,1/7/10,320111,44887,364998
Cairns,2010,8,1/8/10,303105,52202,355307
Cairns,2010,9,1/9/10,301990,49347,351337
Cairns,2010,10,1/10/10,317494,45249,362743
Cairns,2010,11,1/11/10,277842,44313,322155
Cairns,2010,12,1/12/10,284259,45766,330025
Cairns,2011,1,1/1/11,264368,44157,308525
Cairns,2011,2,1/2/11,217608,34887,252495
Cairns,2011,3,1/3/11,242013,39153,281166
Cairns,2011,4,1/4/11,272862,37378,310240
Cairns,2011,5,1/5/11,261662,35860,297522
Cairns,2011,6,1/6/11,285048,37778,322826
Cairns,2011,7,1/7/11,337809,49108,386917
Cairns,2011,8,1/8/11,316946,52806,369752
Cairns,2011,9,1/9/11,296989,47790,344779
Cairns,2011,10,1/10/11,311553,45291,356844
Cairns,2011,11,1/11/11,277158,39153,316311
Cairns,2011,12,1/12/11,277075,40711,317786
Cairns,2012,1,1/1/12,283010,39833,322843
Cairns,2012,2,1/2/12,224259,36582,260841
Cairns,2012,3,1/3/12,256422,41270,297692
Cairns,2012,4,1/4/12,287181,38120,325301
Cairns,2012,5,1/5/12,271564,35313,306877
Cairns,2012,6,1/6/12,298556,38223,336779
Cairns,2012,7,1/7/12,354394,44560,398954
Cairns,2012,8,1/8/12,329768,52894,382662
Cairns,2012,9,1/9/12,316707,46996,363703
Cairns,2012,10,1/10/12,343777,43540,387317
Cairns,2012,11,1/11/12,309616,46171,355787
Cairns,2012,12,1/12/12,293941,47857,341798
Cairns,2013,1,1/1/13,292180,44563,336743
Cairns,2013,2,1/2/13,252852,42018,294870
Cairns,2013,3,1/3/13,262172,42723,304895
Cairns,2013,4,1/4/13,295466,37759,333225
Cairns,2013,5,1/5/13,271091,33343,304434
Cairns,2013,6,1/6/13,318149,35315,353464
Cairns,2013,7,1/7/13,378495,43559,422054
Cairns,2013,8,1/8/13,357690,52260,409950
Cairns,2013,9,1/9/13,340865,41475,382340
Cairns,2013,10,1/10/13,354583,41073,395656
Cairns,2013,11,1/11/13,306639,36018,342657
Cairns,2013,12,1/12/13,324149,41985,366134
Cairns,2014,1,1/1/14,333579,44132,377711
Cairns,2014,2,1/2/14,261719,39246,300965
Cairns,2014,3,1/3/14,272825,37857,310682
Cairns,2014,4,1/4/14,311809,31064,342873
Cairns,2014,5,1/5/14,281123,28967,310090
Cairns,2014,6,1/6/14,303276,31948,335224
Cairns,2014,7,1/7/14,384672,41712,426384
Cairns,2014,8,1/8/14,359834,49468,409302
Cairns,2014,9,1/9/14,342406,41330,383736
Cairns,2014,10,1/10/14,359731,40304,400035
Cairns,2014,11,1/11/14,313692,34165,347857
Cairns,2014,12,1/12/14,332733,40717,373450
Cairns,2015,1,1/1/15,317679,42956,360635
Cairns,2015,2,1/2/15,284189,45036,329225
Cairns,2015,3,1/3/15,282670,40675,323345
Cairns,2015,4,1/4/15,315096,38315,353411
Cairns,2015,5,1/5/15,290539,36765,327304
Cairns,2015,6,1/6/15,319352,36936,356288
Cairns,2015,7,1/7/15,390018,51488,441506
Cairns,2015,8,1/8/15,370789,57648,428437
Cairns,2015,9,1/9/15,351882,50042,401924
Cairns,2015,10,1/10/15,365923,48686,414609
Cairns,2015,11,1/11/15,332816,44903,377719
Cairns,2015,12,1/12/15,354356,52283,406639
Cairns,2016,1,1/1/16,346535,53954,400489
Cairns,2016,2,1/2/16,298043,57828,355871
Cairns,2016,3,1/3/16,319986,56245,376231
Cairns,2016,4,1/4/16,322255,51843,374098
Cairns,2016,5,1/5/16,307712,41758,349470
Cairns,2016,6,1/6/16,340631,43345,383976
Cairns,2016,7,1/7/16,414005,53824,467829
Cairns,2016,8,1/8/16,384920,61624,446544
Cairns,2016,9,1/9/16,374000,56817,430817
Cairns,2016,10,1/10/16,387908,54613,442521
Cairns,2016,11,1/11/16,346608,50685,397293
Cairns,2016,12,1/12/16,365618,59757,425375
Cairns,2017,1,1/1/17,369888,60832,430720
Cairns,2017,2,1/2/17,279361,49084,328445
Cairns,2017,3,1/3/17,317455,57820,375275
Cairns,2017,4,1/4/17,362164,52499,414663
Cairns,2017,5,1/5/17,313311,43926,357237
Cairns,2017,6,1/6/17,334887,46583,381470
Cairns,2017,7,1/7/17,422467,57449,479916
Cairns,2017,8,1/8/17,387376,67500,454876
Cairns,2017,9,1/9/17,374667,56520,431187
Cairns,2017,10,1/10/17,398760,54809,453569
Cairns,2017,11,1/11/17,351039,51381,402420
Cairns,2017,12,1/12/17,366936,63770,430706
Cairns,2018,1,1/1/18,363830,63479,427309
Cairns,2018,2,1/2/18,301952,58428,360380
Cairns,2018,3,1/3/18,327046,59383,386429
Cairns,2018,4,1/4/18,346263,49989,396252
Cairns,2018,5,1/5/18,321416,44000,365416
Cairns,2018,6,1/6/18,335102,45459,380561
Cairns,2018,7,1/7/18,424952,59433,484385
Cairns,2018,8,1/8/18,400213,70165,470378
Cairns,2018,9,1/9/18,368208,53562,421770
Cairns,2018,10,1/10/18,394170,54570,448740
Cairns,2018,11,1/11/18,342962,44856,387818
Cairns,2018,12,1/12/18,357133,59227,416360
Cairns,2019,1,1/1/19,348059,63585,411644
Cairns,2019,2,1/2/19,281899,56610,338509
Canberra,2009,1,1/1/09,209288,0,209288
Canberra,2009,2,1/2/09,230217,0,230217
Canberra,2009,3,1/3/09,280838,0,280838
Canberra,2009,4,1/4/09,264465,0,264465
Canberra,2009,5,1/5/09,266305,0,266305
Canberra,2009,6,1/6/09,258763,0,258763
Canberra,2009,7,1/7/09,270146,0,270146
Canberra,2009,8,1/8/09,279935,0,279935
Canberra,2009,9,1/9/09,278504,0,278504
Canberra,2009,10,1/10/09,276057,0,276057
Canberra,2009,11,1/11/09,276750,0,276750
Canberra,2009,12,1/12/09,257152,0,257152
Canberra,2010,1,1/1/10,223827,0,223827
Canberra,2010,2,1/2/10,253453,0,253453
Canberra,2010,3,1/3/10,317902,0,317902
Canberra,2010,4,1/4/10,276640,0,276640
Canberra,2010,5,1/5/10,271294,0,271294
Canberra,2010,6,1/6/10,276736,0,276736
Canberra,2010,7,1/7/10,280581,0,280581
Canberra,2010,8,1/8/10,274884,0,274884
Canberra,2010,9,1/9/10,280628,0,280628
Canberra,2010,10,1/10/10,293946,0,293946
Canberra,2010,11,1/11/10,290391,0,290391
Canberra,2010,12,1/12/10,263728,0,263728
Canberra,2011,1,1/1/11,215599,0,215599
Canberra,2011,2,1/2/11,242060,0,242060
Canberra,2011,3,1/3/11,295688,0,295688
Canberra,2011,4,1/4/11,270185,0,270185
Canberra,2011,5,1/5/11,276173,0,276173
Canberra,2011,6,1/6/11,256985,0,256985
Canberra,2011,7,1/7/11,280734,0,280734
Canberra,2011,8,1/8/11,283048,0,283048
Canberra,2011,9,1/9/11,284401,0,284401
Canberra,2011,10,1/10/11,272400,0,272400
Canberra,2011,11,1/11/11,278677,0,278677
Canberra,2011,12,1/12/11,252275,0,252275
Canberra,2012,1,1/1/12,208232,0,208232
Canberra,2012,2,1/2/12,238261,0,238261
Canberra,2012,3,1/3/12,285515,0,285515
Canberra,2012,4,1/4/12,253993,0,253993
Canberra,2012,5,1/5/12,269167,0,269167
Canberra,2012,6,1/6/12,251982,0,251982
Canberra,2012,7,1/7/12,259646,0,259646
Canberra,2012,8,1/8/12,265390,0,265390
Canberra,2012,9,1/9/12,259296,0,259296
Canberra,2012,10,1/10/12,269446,0,269446
Canberra,2012,11,1/11/12,270849,0,270849
Canberra,2012,12,1/12/12,234116,0,234116
Canberra,2013,1,1/1/13,197619,0,197619
Canberra,2013,2,1/2/13,224695,0,224695
Canberra,2013,3,1/3/13,271263,0,271263
Canberra,2013,4,1/4/13,248936,0,248936
Canberra,2013,5,1/5/13,260177,0,260177
Canberra,2013,6,1/6/13,252527,0,252527
Canberra,2013,7,1/7/13,255680,0,255680
Canberra,2013,8,1/8/13,254173,0,254173
Canberra,2013,9,1/9/13,242569,0,242569
Canberra,2013,10,1/10/13,262734,0,262734
Canberra,2013,11,1/11/13,256073,0,256073
Canberra,2013,12,1/12/13,230002,0,230002
Canberra,2014,1,1/1/14,187648,0,187648
Canberra,2014,2,1/2/14,209224,0,209224
Canberra,2014,3,1/3/14,250214,0,250214
Canberra,2014,4,1/4/14,229234,0,229234
Canberra,2014,5,1/5/14,244039,0,244039
Canberra,2014,6,1/6/14,236028,0,236028
Canberra,2014,7,1/7/14,244385,0,244385
Canberra,2014,8,1/8/14,241562,0,241562
Canberra,2014,9,1/9/14,243106,0,243106
Canberra,2014,10,1/10/14,260678,0,260678
Canberra,2014,11,1/11/14,242548,0,242548
Canberra,2014,12,1/12/14,223156,0,223156
Canberra,2015,1,1/1/15,181151,0,181151
Canberra,2015,2,1/2/15,205201,0,205201
Canberra,2015,3,1/3/15,251787,0,251787
Canberra,2015,4,1/4/15,231630,0,231630
Canberra,2015,5,1/5/15,242187,0,242187
Canberra,2015,6,1/6/15,237400,0,237400
Canberra,2015,7,1/7/15,247268,0,247268
Canberra,2015,8,1/8/15,241653,0,241653
Canberra,2015,9,1/9/15,243511,0,243511
Canberra,2015,10,1/10/15,249665,0,249665
Canberra,2015,11,1/11/15,250507,0,250507
Canberra,2015,12,1/12/15,223346,0,223346
Canberra,2016,1,1/1/16,181049,0,181049
Canberra,2016,2,1/2/16,223470,0,223470
Canberra,2016,3,1/3/16,252241,0,252241
Canberra,2016,4,1/4/16,240418,0,240418
Canberra,2016,5,1/5/16,242100,0,242100
Canberra,2016,6,1/6/16,235758,0,235758
Canberra,2016,7,1/7/16,246693,0,246693
Canberra,2016,8,1/8/16,250702,0,250702
Canberra,2016,9,1/9/16,252989,3205,256194
Canberra,2016,10,1/10/16,256566,6995,263561
Canberra,2016,11,1/11/16,265734,6667,272401
Canberra,2016,12,1/12/16,238073,6904,244977
Canberra,2017,1,1/1/17,191726,8068,199794
Canberra,2017,2,1/2/17,225451,5907,231358
Canberra,2017,3,1/3/17,273652,6509,280161
Canberra,2017,4,1/4/17,237379,7388,244767
Canberra,2017,5,1/5/17,258539,5531,264070
Canberra,2017,6,1/6/17,251985,6758,258743
Canberra,2017,7,1/7/17,258987,6887,265874
Canberra,2017,8,1/8/17,262384,6553,268937
Canberra,2017,9,1/9/17,267430,7274,274704
Canberra,2017,10,1/10/17,272010,7556,279566
Canberra,2017,11,1/11/17,276338,7163,283501
Canberra,2017,12,1/12/17,245459,8841,254300
Canberra,2018,1,1/1/18,199095,8992,208087
Canberra,2018,2,1/2/18,234413,7015,241428
Canberra,2018,3,1/3/18,282710,7712,290422
Canberra,2018,4,1/4/18,257254,9576,266830
Canberra,2018,5,1/5/18,272724,7155,279879
Canberra,2018,6,1/6/18,256986,8195,265181
Canberra,2018,7,1/7/18,280265,8782,289047
Canberra,2018,8,1/8/18,282451,7838,290289
Canberra,2018,9,1/9/18,270166,8468,278634
Canberra,2018,10,1/10/18,292060,7283,299343
Canberra,2018,11,1/11/18,286692,7027,293719
Canberra,2018,12,1/12/18,238327,6879,245206
Canberra,2019,1,1/1/19,201548,6735,208283
Canberra,2019,2,1/2/19,239012,5517,244529
Darwin,2009,1,1/1/09,91425,16729,108154
Darwin,2009,2,1/2/09,74666,10820,85486
Darwin,2009,3,1/3/09,88028,10389,98417
Darwin,2009,4,1/4/09,107091,14829,121920
Darwin,2009,5,1/5/09,118392,16907,135299
Darwin,2009,6,1/6/09,131354,18426,149780
Darwin,2009,7,1/7/09,145239,19498,164737
Darwin,2009,8,1/8/09,134606,19118,153724
Darwin,2009,9,1/9/09,124713,18153,142866
Darwin,2009,10,1/10/09,116651,17432,134083
Darwin,2009,11,1/11/09,95702,15676,111378
Darwin,2009,12,1/12/09,96932,17765,114697
Darwin,2010,1,1/1/10,93253,19459,112712
Darwin,2010,2,1/2/10,81646,13617,95263
Darwin,2010,3,1/3/10,102497,14071,116568
Darwin,2010,4,1/4/10,109284,16789,126073
Darwin,2010,5,1/5/10,116949,17162,134111
Darwin,2010,6,1/6/10,131301,19085,150386
Darwin,2010,7,1/7/10,155019,22668,177687
Darwin,2010,8,1/8/10,143066,20447,163513
Darwin,2010,9,1/9/10,135942,19712,155654
Darwin,2010,10,1/10/10,126041,18274,144315
Darwin,2010,11,1/11/10,102324,15972,118296
Darwin,2010,12,1/12/10,108646,19749,128395
Darwin,2011,1,1/1/11,102790,25487,128277
Darwin,2011,2,1/2/11,77120,18478,95598
Darwin,2011,3,1/3/11,99957,20464,120421
Darwin,2011,4,1/4/11,115129,23492,138621
Darwin,2011,5,1/5/11,118712,23106,141818
Darwin,2011,6,1/6/11,128718,24365,153083
Darwin,2011,7,1/7/11,186513,34179,220692
Darwin,2011,8,1/8/11,165978,30719,196697
Darwin,2011,9,1/9/11,149596,30810,180406
Darwin,2011,10,1/10/11,150285,32389,182674
Darwin,2011,11,1/11/11,131857,31154,163011
Darwin,2011,12,1/12/11,133115,32292,165407
Darwin,2012,1,1/1/12,126246,33868,160114
Darwin,2012,2,1/2/12,107527,25784,133311
Darwin,2012,3,1/3/12,123254,25947,149201
Darwin,2012,4,1/4/12,130492,27148,157640
Darwin,2012,5,1/5/12,133399,24420,157819
Darwin,2012,6,1/6/12,149150,28500,177650
Darwin,2012,7,1/7/12,171855,33129,204984
Darwin,2012,8,1/8/12,156107,27555,183662
Darwin,2012,9,1/9/12,140815,25226,166041
Darwin,2012,10,1/10/12,133643,27156,160799
Darwin,2012,11,1/11/12,119955,23677,143632
Darwin,2012,12,1/12/12,119635,26304,145939
Darwin,2013,1,1/1/13,116512,27993,144505
Darwin,2013,2,1/2/13,94610,21485,116095
Darwin,2013,3,1/3/13,123576,24404,147980
Darwin,2013,4,1/4/13,133559,26240,159799
Darwin,2013,5,1/5/13,132059,24140,156199
Darwin,2013,6,1/6/13,147195,25723,172918
Darwin,2013,7,1/7/13,172526,33603,206129
Darwin,2013,8,1/8/13,161291,30753,192044
Darwin,2013,9,1/9/13,149500,30122,179622
Darwin,2013,10,1/10/13,156043,30106,186149
Darwin,2013,11,1/11/13,125513,26735,152248
Darwin,2013,12,1/12/13,131547,31913,163460
Darwin,2014,1,1/1/14,124658,34667,159325
Darwin,2014,2,1/2/14,102892,23155,126047
Darwin,2014,3,1/3/14,121522,24208,145730
Darwin,2014,4,1/4/14,144484,22854,167338
Darwin,2014,5,1/5/14,144204,23146,167350
Darwin,2014,6,1/6/14,171576,27564,199140
Darwin,2014,7,1/7/14,189095,31135,220230
Darwin,2014,8,1/8/14,176291,30346,206637
Darwin,2014,9,1/9/14,158085,27740,185825
Darwin,2014,10,1/10/14,158301,27254,185555
Darwin,2014,11,1/11/14,132242,21821,154063
Darwin,2014,12,1/12/14,137189,24780,161969
Darwin,2015,1,1/1/15,124377,25729,150106
Darwin,2015,2,1/2/15,102522,18791,121313
Darwin,2015,3,1/3/15,125996,20094,146090
Darwin,2015,4,1/4/15,144072,20018,164090
Darwin,2015,5,1/5/15,147394,21442,168836
Darwin,2015,6,1/6/15,169595,23068,192663
Darwin,2015,7,1/7/15,195605,27240,222845
Darwin,2015,8,1/8/15,175176,23499,198675
Darwin,2015,9,1/9/15,162476,21279,183755
Darwin,2015,10,1/10/15,154078,20791,174869
Darwin,2015,11,1/11/15,133274,18641,151915
Darwin,2015,12,1/12/15,134196,22195,156391
Darwin,2016,1,1/1/16,124718,24712,149430
Darwin,2016,2,1/2/16,106536,16718,123254
Darwin,2016,3,1/3/16,130515,17924,148439
Darwin,2016,4,1/4/16,142935,19829,162764
Darwin,2016,5,1/5/16,150562,21756,172318
Darwin,2016,6,1/6/16,172733,23883,196616
Darwin,2016,7,1/7/16,193370,29485,222855
Darwin,2016,8,1/8/16,177543,25325,202868
Darwin,2016,9,1/9/16,163210,23857,187067
Darwin,2016,10,1/10/16,164121,23383,187504
Darwin,2016,11,1/11/16,137105,19197,156302
Darwin,2016,12,1/12/16,139781,26000,165781
Darwin,2017,1,1/1/17,133006,28976,161982
Darwin,2017,2,1/2/17,106758,18771,125529
Darwin,2017,3,1/3/17,130465,19414,149879
Darwin,2017,4,1/4/17,145541,23067,168608
Darwin,2017,5,1/5/17,146897,21133,168030
Darwin,2017,6,1/6/17,170807,25528,196335
Darwin,2017,7,1/7/17,194184,27915,222099
Darwin,2017,8,1/8/17,181932,24195,206127
Darwin,2017,9,1/9/17,159949,22176,182125
Darwin,2017,10,1/10/17,158995,21895,180890
Darwin,2017,11,1/11/17,136257,19108,155365
Darwin,2017,12,1/12/17,137207,22679,159886
Darwin,2018,1,1/1/18,129687,25929,155616
Darwin,2018,2,1/2/18,103333,16283,119616
Darwin,2018,3,1/3/18,127354,15824,143178
Darwin,2018,4,1/4/18,140267,18107,158374
Darwin,2018,5,1/5/18,147236,16163,163399
Darwin,2018,6,1/6/18,162414,20907,183321
Darwin,2018,7,1/7/18,193951,20395,214346
Darwin,2018,8,1/8/18,174835,20540,195375
Darwin,2018,9,1/9/18,160451,18338,178789
Darwin,2018,10,1/10/18,152320,17961,170281
Darwin,2018,11,1/11/18,124123,17044,141167
Darwin,2018,12,1/12/18,127821,21100,148921
Darwin,2019,1,1/1/19,118878,23381,142259
Darwin,2019,2,1/2/19,101357,15890,117247
Gold Coast,2009,1,1/1/09,394783,51520,446303
Gold Coast,2009,2,1/2/09,310807,43252,354059
Gold Coast,2009,3,1/3/09,352490,48055,400545
Gold Coast,2009,4,1/4/09,353443,45251,398694
Gold Coast,2009,5,1/5/09,331644,49313,380957
Gold Coast,2009,6,1/6/09,309837,42403,352240
Gold Coast,2009,7,1/7/09,364120,48278,412398
Gold Coast,2009,8,1/8/09,356277,56531,412808
Gold Coast,2009,9,1/9/09,371060,61889,432949
Gold Coast,2009,10,1/10/09,391315,61650,452965
Gold Coast,2009,11,1/11/09,357607,62272,419879
Gold Coast,2009,12,1/12/09,353053,65918,418971
Gold Coast,2010,1,1/1/10,395052,68818,463870
Gold Coast,2010,2,1/2/10,361539,62510,424049
Gold Coast,2010,3,1/3/10,393163,71368,464531
Gold Coast,2010,4,1/4/10,390742,60743,451485
Gold Coast,2010,5,1/5/10,363421,54366,417787
Gold Coast,2010,6,1/6/10,358864,55591,414455
Gold Coast,2010,7,1/7/10,418900,63956,482856
Gold Coast,2010,8,1/8/10,389109,71713,460822
Gold Coast,2010,9,1/9/10,412866,68283,481149
Gold Coast,2010,10,1/10/10,420873,66990,487863
Gold Coast,2010,11,1/11/10,404937,66063,471000
Gold Coast,2010,12,1/12/10,420485,76268,496753
Gold Coast,2011,1,1/1/11,482289,79326,561615
Gold Coast,2011,2,1/2/11,341385,64068,405453
Gold Coast,2011,3,1/3/11,373225,62786,436011
Gold Coast,2011,4,1/4/11,379626,53911,433537
Gold Coast,2011,5,1/5/11,344397,53751,398148
Gold Coast,2011,6,1/6/11,326280,44585,370865
Gold Coast,2011,7,1/7/11,391092,53214,444306
Gold Coast,2011,8,1/8/11,360019,62176,422195
Gold Coast,2011,9,1/9/11,379789,53780,433569
Gold Coast,2011,10,1/10/11,407864,59831,467695
Gold Coast,2011,11,1/11/11,385568,58878,444446
Gold Coast,2011,12,1/12/11,409766,69557,479323
Gold Coast,2012,1,1/1/12,443910,72172,516082
Gold Coast,2012,2,1/2/12,357671,61063,418734
Gold Coast,2012,3,1/3/12,393185,64068,457253
Gold Coast,2012,4,1/4/12,392289,58857,451146
Gold Coast,2012,5,1/5/12,337799,49232,387031
Gold Coast,2012,6,1/6/12,342614,62176,404790
Gold Coast,2012,7,1/7/12,409914,75272,485186
Gold Coast,2012,8,1/8/12,389023,73056,462079
Gold Coast,2012,9,1/9/12,443540,71284,514824
Gold Coast,2012,10,1/10/12,462845,75623,538468
Gold Coast,2012,11,1/11/12,429324,72129,501453
Gold Coast,2012,12,1/12/12,452771,89492,542263
Gold Coast,2013,1,1/1/13,465651,88233,553884
Gold Coast,2013,2,1/2/13,357805,70389,428194
Gold Coast,2013,3,1/3/13,399646,77248,476894
Gold Coast,2013,4,1/4/13,413422,65807,479229
Gold Coast,2013,5,1/5/13,343045,60981,404026
Gold Coast,2013,6,1/6/13,355424,63022,418446
Gold Coast,2013,7,1/7/13,425469,70657,496126
Gold Coast,2013,8,1/8/13,397035,71713,468748
Gold Coast,2013,9,1/9/13,429212,68346,497558
Gold Coast,2013,10,1/10/13,467056,72377,539433
Gold Coast,2013,11,1/11/13,399136,68134,467270
Gold Coast,2013,12,1/12/13,449305,87998,537303
Gold Coast,2014,1,1/1/14,482165,93012,575177
Gold Coast,2014,2,1/2/14,356191,73294,429485
Gold Coast,2014,3,1/3/14,395498,75397,470895
Gold Coast,2014,4,1/4/14,401760,68566,470326
Gold Coast,2014,5,1/5/14,354168,60389,414557
Gold Coast,2014,6,1/6/14,351232,65427,416659
Gold Coast,2014,7,1/7/14,428940,77142,506082
Gold Coast,2014,8,1/8/14,403253,72577,475830
Gold Coast,2014,9,1/9/14,428273,69155,497428
Gold Coast,2014,10,1/10/14,475540,72469,548009
Gold Coast,2014,11,1/11/14,412304,69284,481588
Gold Coast,2014,12,1/12/14,458529,84259,542788
Gold Coast,2015,1,1/1/15,476215,87907,564122
Gold Coast,2015,2,1/2/15,356609,68048,424657
Gold Coast,2015,3,1/3/15,399943,72862,472805
Gold Coast,2015,4,1/4/15,416149,71270,487419
Gold Coast,2015,5,1/5/15,366812,65763,432575
Gold Coast,2015,6,1/6/15,365899,68221,434120
Gold Coast,2015,7,1/7/15,451304,89818,541122
Gold Coast,2015,8,1/8/15,412432,75230,487662
Gold Coast,2015,9,1/9/15,454749,82921,537670
Gold Coast,2015,10,1/10/15,478036,86057,564093
Gold Coast,2015,11,1/11/15,430836,78158,508994
Gold Coast,2015,12,1/12/15,472407,96712,569119
Gold Coast,2016,1,1/1/16,516187,96249,612436
Gold Coast,2016,2,1/2/16,399958,79077,479035
Gold Coast,2016,3,1/3/16,437430,90673,528103
Gold Coast,2016,4,1/4/16,432475,85440,517915
Gold Coast,2016,5,1/5/16,383974,78071,462045
Gold Coast,2016,6,1/6/16,381415,83797,465212
Gold Coast,2016,7,1/7/16,468577,106980,575557
Gold Coast,2016,8,1/8/16,425852,96204,522056
Gold Coast,2016,9,1/9/16,461229,96880,558109
Gold Coast,2016,10,1/10/16,488023,92944,580967
Gold Coast,2016,11,1/11/16,439507,84659,524166
Gold Coast,2016,12,1/12/16,483130,102584,585714
Gold Coast,2017,1,1/1/17,519274,103891,623165
Gold Coast,2017,2,1/2/17,387530,79072,466602
Gold Coast,2017,3,1/3/17,427526,87140,514666
Gold Coast,2017,4,1/4/17,463896,94224,558120
Gold Coast,2017,5,1/5/17,396610,78638,475248
Gold Coast,2017,6,1/6/17,391035,81771,472806
Gold Coast,2017,7,1/7/17,479160,96073,575233
Gold Coast,2017,8,1/8/17,424804,90270,515074
Gold Coast,2017,9,1/9/17,459920,87763,547683
Gold Coast,2017,10,1/10/17,492906,94235,587141
Gold Coast,2017,11,1/11/17,454388,84533,538921
Gold Coast,2017,12,1/12/17,501936,102488,604424
Gold Coast,2018,1,1/1/18,546266,103065,649331
Gold Coast,2018,2,1/2/18,399352,78215,477567
Gold Coast,2018,3,1/3/18,451445,88293,539738
Gold Coast,2018,4,1/4/18,477466,90335,567801
Gold Coast,2018,5,1/5/18,392798,74786,467584
Gold Coast,2018,6,1/6/18,390559,80355,470914
Gold Coast,2018,7,1/7/18,477736,93621,571357
Gold Coast,2018,8,1/8/18,447670,85896,533566
Gold Coast,2018,9,1/9/18,456554,79182,535736
Gold Coast,2018,10,1/10/18,487025,86575,573600
Gold Coast,2018,11,1/11/18,446924,73826,520750
Gold Coast,2018,12,1/12/18,487389,91049,578438
Gold Coast,2019,1,1/1/19,542174,95623,637797
Gold Coast,2019,2,1/2/19,388248,70223,458471
Hobart,2009,1,1/1/09,184809,0,184809
Hobart,2009,2,1/2/09,158193,0,158193
Hobart,2009,3,1/3/09,173896,0,173896
Hobart,2009,4,1/4/09,162306,0,162306
Hobart,2009,5,1/5/09,148346,0,148346
Hobart,2009,6,1/6/09,132300,0,132300
Hobart,2009,7,1/7/09,139697,0,139697
Hobart,2009,8,1/8/09,146013,0,146013
Hobart,2009,9,1/9/09,150711,0,150711
Hobart,2009,10,1/10/09,157938,0,157938
Hobart,2009,11,1/11/09,156326,0,156326
Hobart,2009,12,1/12/09,163924,0,163924
Hobart,2010,1,1/1/10,172077,0,172077
Hobart,2010,2,1/2/10,157593,0,157593
Hobart,2010,3,1/3/10,167728,0,167728
Hobart,2010,4,1/4/10,159126,0,159126
Hobart,2010,5,1/5/10,147065,0,147065
Hobart,2010,6,1/6/10,137673,0,137673
Hobart,2010,7,1/7/10,144598,0,144598
Hobart,2010,8,1/8/10,143960,0,143960
Hobart,2010,9,1/9/10,151459,0,151459
Hobart,2010,10,1/10/10,156173,0,156173
Hobart,2010,11,1/11/10,161287,0,161287
Hobart,2010,12,1/12/10,183353,0,183353
Hobart,2011,1,1/1/11,199384,0,199384
Hobart,2011,2,1/2/11,162913,0,162913
Hobart,2011,3,1/3/11,177930,0,177930
Hobart,2011,4,1/4/11,156455,0,156455
Hobart,2011,5,1/5/11,145879,0,145879
Hobart,2011,6,1/6/11,119774,0,119774
Hobart,2011,7,1/7/11,135786,0,135786
Hobart,2011,8,1/8/11,135050,0,135050
Hobart,2011,9,1/9/11,140928,0,140928
Hobart,2011,10,1/10/11,150448,0,150448
Hobart,2011,11,1/11/11,153076,0,153076
Hobart,2011,12,1/12/11,167058,0,167058
Hobart,2012,1,1/1/12,182301,0,182301
Hobart,2012,2,1/2/12,155295,0,155295
Hobart,2012,3,1/3/12,166159,0,166159
Hobart,2012,4,1/4/12,153958,0,153958
Hobart,2012,5,1/5/12,139870,0,139870
Hobart,2012,6,1/6/12,134708,0,134708
Hobart,2012,7,1/7/12,140625,0,140625
Hobart,2012,8,1/8/12,140216,0,140216
Hobart,2012,9,1/9/12,156108,0,156108
Hobart,2012,10,1/10/12,166109,0,166109
Hobart,2012,11,1/11/12,182513,0,182513
Hobart,2012,12,1/12/12,201164,0,201164
Hobart,2013,1,1/1/13,207905,0,207905
Hobart,2013,2,1/2/13,169053,0,169053
Hobart,2013,3,1/3/13,191793,0,191793
Hobart,2013,4,1/4/13,178356,0,178356
Hobart,2013,5,1/5/13,150016,0,150016
Hobart,2013,6,1/6/13,142693,0,142693
Hobart,2013,7,1/7/13,164872,0,164872
Hobart,2013,8,1/8/13,159649,0,159649
Hobart,2013,9,1/9/13,160641,0,160641
Hobart,2013,10,1/10/13,180907,0,180907
Hobart,2013,11,1/11/13,181507,0,181507
Hobart,2013,12,1/12/13,204314,0,204314
Hobart,2014,1,1/1/14,212436,0,212436
Hobart,2014,2,1/2/14,171232,0,171232
Hobart,2014,3,1/3/14,192294,0,192294
Hobart,2014,4,1/4/14,174940,0,174940
Hobart,2014,5,1/5/14,153354,0,153354
Hobart,2014,6,1/6/14,150496,0,150496
Hobart,2014,7,1/7/14,167840,0,167840
Hobart,2014,8,1/8/14,158639,0,158639
Hobart,2014,9,1/9/14,160176,0,160176
Hobart,2014,10,1/10/14,186458,0,186458
Hobart,2014,11,1/11/14,188538,0,188538
Hobart,2014,12,1/12/14,211578,0,211578
Hobart,2015,1,1/1/15,225755,0,225755
Hobart,2015,2,1/2/15,186006,0,186006
Hobart,2015,3,1/3/15,199193,0,199193
Hobart,2015,4,1/4/15,183667,0,183667
Hobart,2015,5,1/5/15,162490,0,162490
Hobart,2015,6,1/6/15,156018,0,156018
Hobart,2015,7,1/7/15,173315,0,173315
Hobart,2015,8,1/8/15,161551,0,161551
Hobart,2015,9,1/9/15,170156,0,170156
Hobart,2015,10,1/10/15,193735,0,193735
Hobart,2015,11,1/11/15,199596,0,199596
Hobart,2015,12,1/12/15,226950,0,226950
Hobart,2016,1,1/1/16,232476,0,232476
Hobart,2016,2,1/2/16,195914,0,195914
Hobart,2016,3,1/3/16,212047,0,212047
Hobart,2016,4,1/4/16,197064,0,197064
Hobart,2016,5,1/5/16,176551,0,176551
Hobart,2016,6,1/6/16,173584,0,173584
Hobart,2016,7,1/7/16,183639,0,183639
Hobart,2016,8,1/8/16,168478,0,168478
Hobart,2016,9,1/9/16,185094,0,185094
Hobart,2016,10,1/10/16,205417,0,205417
Hobart,2016,11,1/11/16,207040,0,207040
Hobart,2016,12,1/12/16,240833,0,240833
Hobart,2017,1,1/1/17,250267,0,250267
Hobart,2017,2,1/2/17,205384,0,205384
Hobart,2017,3,1/3/17,219238,0,219238
Hobart,2017,4,1/4/17,214518,0,214518
Hobart,2017,5,1/5/17,180575,0,180575
Hobart,2017,6,1/6/17,180309,0,180309
Hobart,2017,7,1/7/17,201627,0,201627
Hobart,2017,8,1/8/17,175246,0,175246
Hobart,2017,9,1/9/17,189460,0,189460
Hobart,2017,10,1/10/17,217102,0,217102
Hobart,2017,11,1/11/17,221112,0,221112
Hobart,2017,12,1/12/17,255505,0,255505
Hobart,2018,1,1/1/18,266584,0,266584
Hobart,2018,2,1/2/18,223015,0,223015
Hobart,2018,3,1/3/18,248498,0,248498
Hobart,2018,4,1/4/18,229894,0,229894
Hobart,2018,5,1/5/18,183573,0,183573
Hobart,2018,6,1/6/18,184480,0,184480
Hobart,2018,7,1/7/18,212892,0,212892
Hobart,2018,8,1/8/18,188905,0,188905
Hobart,2018,9,1/9/18,198692,0,198692
Hobart,2018,10,1/10/18,235768,0,235768
Hobart,2018,11,1/11/18,237664,0,237664
Hobart,2018,12,1/12/18,266663,0,266663
Hobart,2019,1,1/1/19,278206,0,278206
Hobart,2019,2,1/2/19,231911,0,231911
Karratha,2009,1,1/1/09,35212,0,35212
Karratha,2009,2,1/2/09,36709,0,36709
Karratha,2009,3,1/3/09,41000,0,41000
Karratha,2009,4,1/4/09,43365,0,43365
Karratha,2009,5,1/5/09,44128,0,44128
Karratha,2009,6,1/6/09,44778,0,44778
Karratha,2009,7,1/7/09,48262,0,48262
Karratha,2009,8,1/8/09,47285,0,47285
Karratha,2009,9,1/9/09,50460,0,50460
Karratha,2009,10,1/10/09,51650,0,51650
Karratha,2009,11,1/11/09,50290,0,50290
Karratha,2009,12,1/12/09,46030,0,46030
Karratha,2010,1,1/1/10,44123,0,44123
Karratha,2010,2,1/2/10,44658,0,44658
Karratha,2010,3,1/3/10,53579,0,53579
Karratha,2010,4,1/4/10,49547,0,49547
Karratha,2010,5,1/5/10,50107,0,50107
Karratha,2010,6,1/6/10,51220,0,51220
Karratha,2010,7,1/7/10,55652,0,55652
Karratha,2010,8,1/8/10,54083,0,54083
Karratha,2010,9,1/9/10,55690,0,55690
Karratha,2010,10,1/10/10,58726,0,58726
Karratha,2010,11,1/11/10,57787,0,57787
Karratha,2010,12,1/12/10,53635,0,53635
Karratha,2011,1,1/1/11,50603,0,50603
Karratha,2011,2,1/2/11,50071,0,50071
Karratha,2011,3,1/3/11,60875,0,60875
Karratha,2011,4,1/4/11,57365,0,57365
Karratha,2011,5,1/5/11,61690,0,61690
Karratha,2011,6,1/6/11,59030,0,59030
Karratha,2011,7,1/7/11,67620,0,67620
Karratha,2011,8,1/8/11,69045,0,69045
Karratha,2011,9,1/9/11,66852,0,66852
Karratha,2011,10,1/10/11,65088,0,65088
Karratha,2011,11,1/11/11,70204,0,70204
Karratha,2011,12,1/12/11,61868,0,61868
Karratha,2012,1,1/1/12,61735,0,61735
Karratha,2012,2,1/2/12,64623,0,64623
Karratha,2012,3,1/3/12,67709,0,67709
Karratha,2012,4,1/4/12,65109,0,65109
Karratha,2012,5,1/5/12,71426,0,71426
Karratha,2012,6,1/6/12,67022,0,67022
Karratha,2012,7,1/7/12,72519,0,72519
Karratha,2012,8,1/8/12,72732,0,72732
Karratha,2012,9,1/9/12,67583,0,67583
Karratha,2012,10,1/10/12,75322,0,75322
Karratha,2012,11,1/11/12,71534,0,71534
Karratha,2012,12,1/12/12,61101,0,61101
Karratha,2013,1,1/1/13,64572,0,64572
Karratha,2013,2,1/2/13,56830,0,56830
Karratha,2013,3,1/3/13,67750,0,67750
Karratha,2013,4,1/4/13,69585,0,69585
Karratha,2013,5,1/5/13,71991,0,71991
Karratha,2013,6,1/6/13,64005,0,64005
Karratha,2013,7,1/7/13,70376,0,70376
Karratha,2013,8,1/8/13,63514,0,63514
Karratha,2013,9,1/9/13,60801,0,60801
Karratha,2013,10,1/10/13,66135,0,66135
Karratha,2013,11,1/11/13,60159,0,60159
Karratha,2013,12,1/12/13,54897,0,54897
Karratha,2014,1,1/1/14,58369,0,58369
Karratha,2014,2,1/2/14,55555,0,55555
Karratha,2014,3,1/3/14,59034,0,59034
Karratha,2014,4,1/4/14,60206,0,60206
Karratha,2014,5,1/5/14,61659,0,61659
Karratha,2014,6,1/6/14,57093,0,57093
Karratha,2014,7,1/7/14,62633,0,62633
Karratha,2014,8,1/8/14,60761,0,60761
Karratha,2014,9,1/9/14,60430,0,60430
Karratha,2014,10,1/10/14,64776,0,64776
Karratha,2014,11,1/11/14,57388,0,57388
Karratha,2014,12,1/12/14,52464,0,52464
Karratha,2015,1,1/1/15,49166,0,49166
Karratha,2015,2,1/2/15,48714,0,48714
Karratha,2015,3,1/3/15,51828,0,51828
Karratha,2015,4,1/4/15,52583,0,52583
Karratha,2015,5,1/5/15,50202,0,50202
Karratha,2015,6,1/6/15,49995,0,49995
Karratha,2015,7,1/7/15,55213,0,55213
Karratha,2015,8,1/8/15,50149,0,50149
Karratha,2015,9,1/9/15,51820,0,51820
Karratha,2015,10,1/10/15,52010,0,52010
Karratha,2015,11,1/11/15,50117,0,50117
Karratha,2015,12,1/12/15,45789,0,45789
Karratha,2016,1,1/1/16,40139,0,40139
Karratha,2016,2,1/2/16,39180,0,39180
Karratha,2016,3,1/3/16,42765,0,42765
Karratha,2016,4,1/4/16,41920,0,41920
Karratha,2016,5,1/5/16,46283,0,46283
Karratha,2016,6,1/6/16,41394,0,41394
Karratha,2016,7,1/7/16,41239,0,41239
Karratha,2016,8,1/8/16,41920,0,41920
Karratha,2016,9,1/9/16,41591,0,41591
Karratha,2016,10,1/10/16,41162,0,41162
Karratha,2016,11,1/11/16,42004,0,42004
Karratha,2016,12,1/12/16,35297,0,35297
Karratha,2017,1,1/1/17,34832,0,34832
Karratha,2017,2,1/2/17,33327,0,33327
Karratha,2017,3,1/3/17,38957,0,38957
Karratha,2017,4,1/4/17,35587,0,35587
Karratha,2017,5,1/5/17,39687,0,39687
Karratha,2017,6,1/6/17,38363,0,38363
Karratha,2017,7,1/7/17,36530,0,36530
Karratha,2017,8,1/8/17,37596,0,37596
Karratha,2017,9,1/9/17,35285,0,35285
Karratha,2017,10,1/10/17,38147,0,38147
Karratha,2017,11,1/11/17,37531,0,37531
Karratha,2017,12,1/12/17,33205,0,33205
Karratha,2018,1,1/1/18,33500,0,33500
Karratha,2018,2,1/2/18,32428,0,32428
Karratha,2018,3,1/3/18,36553,0,36553
Karratha,2018,4,1/4/18,35954,0,35954
Karratha,2018,5,1/5/18,39248,0,39248
Karratha,2018,6,1/6/18,36919,0,36919
Karratha,2018,7,1/7/18,40136,0,40136
Karratha,2018,8,1/8/18,40180,0,40180
Karratha,2018,9,1/9/18,36730,0,36730
Karratha,2018,10,1/10/18,39582,0,39582
Karratha,2018,11,1/11/18,37977,0,37977
Karratha,2018,12,1/12/18,32242,0,32242
Karratha,2019,1,1/1/19,35731,0,35731
Karratha,2019,2,1/2/19,33811,0,33811
Launceston,2009,1,1/1/09,110202,0,110202
Launceston,2009,2,1/2/09,93002,0,93002
Launceston,2009,3,1/3/09,105197,0,105197
Launceston,2009,4,1/4/09,97161,0,97161
Launceston,2009,5,1/5/09,89835,0,89835
Launceston,2009,6,1/6/09,84736,0,84736
Launceston,2009,7,1/7/09,88014,0,88014
Launceston,2009,8,1/8/09,89019,0,89019
Launceston,2009,9,1/9/09,91210,0,91210
Launceston,2009,10,1/10/09,94200,0,94200
Launceston,2009,11,1/11/09,94892,0,94892
Launceston,2009,12,1/12/09,98906,0,98906
Launceston,2010,1,1/1/10,106007,0,106007
Launceston,2010,2,1/2/10,94505,0,94505
Launceston,2010,3,1/3/10,100781,0,100781
Launceston,2010,4,1/4/10,100119,0,100119
Launceston,2010,5,1/5/10,88629,0,88629
Launceston,2010,6,1/6/10,85044,0,85044
Launceston,2010,7,1/7/10,89194,0,89194
Launceston,2010,8,1/8/10,88937,0,88937
Launceston,2010,9,1/9/10,91913,0,91913
Launceston,2010,10,1/10/10,97389,0,97389
Launceston,2010,11,1/11/10,97383,0,97383
Launceston,2010,12,1/12/10,118066,0,118066
Launceston,2011,1,1/1/11,115583,0,115583
Launceston,2011,2,1/2/11,95134,0,95134
Launceston,2011,3,1/3/11,106731,0,106731
Launceston,2011,4,1/4/11,96532,0,96532
Launceston,2011,5,1/5/11,85979,0,85979
Launceston,2011,6,1/6/11,73515,0,73515
Launceston,2011,7,1/7/11,84628,0,84628
Launceston,2011,8,1/8/11,85162,0,85162
Launceston,2011,9,1/9/11,86978,0,86978
Launceston,2011,10,1/10/11,91265,0,91265
Launceston,2011,11,1/11/11,96466,0,96466
Launceston,2011,12,1/12/11,107641,0,107641
Launceston,2012,1,1/1/12,113789,0,113789
Launceston,2012,2,1/2/12,93314,0,93314
Launceston,2012,3,1/3/12,101345,0,101345
Launceston,2012,4,1/4/12,97383,0,97383
Launceston,2012,5,1/5/12,87178,0,87178
Launceston,2012,6,1/6/12,85027,0,85027
Launceston,2012,7,1/7/12,83773,0,83773
Launceston,2012,8,1/8/12,88289,0,88289
Launceston,2012,9,1/9/12,97098,0,97098
Launceston,2012,10,1/10/12,98736,0,98736
Launceston,2012,11,1/11/12,107299,0,107299
Launceston,2012,12,1/12/12,119042,0,119042
Launceston,2013,1,1/1/13,127407,0,127407
Launceston,2013,2,1/2/13,101438,0,101438
Launceston,2013,3,1/3/13,115300,0,115300
Launceston,2013,4,1/4/13,112090,0,112090
Launceston,2013,5,1/5/13,89347,0,89347
Launceston,2013,6,1/6/13,82894,0,82894
Launceston,2013,7,1/7/13,100802,0,100802
Launceston,2013,8,1/8/13,94050,0,94050
Launceston,2013,9,1/9/13,92843,0,92843
Launceston,2013,10,1/10/13,110535,0,110535
Launceston,2013,11,1/11/13,104324,0,104324
Launceston,2013,12,1/12/13,126115,0,126115
Launceston,2014,1,1/1/14,134981,0,134981
Launceston,2014,2,1/2/14,104308,0,104308
Launceston,2014,3,1/3/14,117743,0,117743
Launceston,2014,4,1/4/14,110969,0,110969
Launceston,2014,5,1/5/14,95670,0,95670
Launceston,2014,6,1/6/14,93944,0,93944
Launceston,2014,7,1/7/14,97220,0,97220
Launceston,2014,8,1/8/14,90439,0,90439
Launceston,2014,9,1/9/14,95520,0,95520
Launceston,2014,10,1/10/14,109628,0,109628
Launceston,2014,11,1/11/14,111351,0,111351
Launceston,2014,12,1/12/14,127409,0,127409
Launceston,2015,1,1/1/15,131117,0,131117
Launceston,2015,2,1/2/15,105078,0,105078
Launceston,2015,3,1/3/15,117067,0,117067
Launceston,2015,4,1/4/15,107596,0,107596
Launceston,2015,5,1/5/15,94902,0,94902
Launceston,2015,6,1/6/15,84871,0,84871
Launceston,2015,7,1/7/15,101133,0,101133
Launceston,2015,8,1/8/15,91516,0,91516
Launceston,2015,9,1/9/15,93627,0,93627
Launceston,2015,10,1/10/15,109994,0,109994
Launceston,2015,11,1/11/15,116342,0,116342
Launceston,2015,12,1/12/15,133165,0,133165
Launceston,2016,1,1/1/16,135723,0,135723
Launceston,2016,2,1/2/16,114135,0,114135
Launceston,2016,3,1/3/16,122451,0,122451
Launceston,2016,4,1/4/16,115273,0,115273
Launceston,2016,5,1/5/16,96652,0,96652
Launceston,2016,6,1/6/16,90941,0,90941
Launceston,2016,7,1/7/16,107754,0,107754
Launceston,2016,8,1/8/16,89603,0,89603
Launceston,2016,9,1/9/16,99014,0,99014
Launceston,2016,10,1/10/16,108098,0,108098
Launceston,2016,11,1/11/16,115117,0,115117
Launceston,2016,12,1/12/16,136264,0,136264
Launceston,2017,1,1/1/17,143186,0,143186
Launceston,2017,2,1/2/17,114286,0,114286
Launceston,2017,3,1/3/17,120601,0,120601
Launceston,2017,4,1/4/17,118988,0,118988
Launceston,2017,5,1/5/17,94302,0,94302
Launceston,2017,6,1/6/17,87920,0,87920
Launceston,2017,7,1/7/17,104995,0,104995
Launceston,2017,8,1/8/17,90076,0,90076
Launceston,2017,9,1/9/17,98643,0,98643
Launceston,2017,10,1/10/17,110802,0,110802
Launceston,2017,11,1/11/17,117211,0,117211
Launceston,2017,12,1/12/17,140212,0,140212
Launceston,2018,1,1/1/18,147294,0,147294
Launceston,2018,2,1/2/18,113834,0,113834
Launceston,2018,3,1/3/18,132385,0,132385
Launceston,2018,4,1/4/18,123005,0,123005
Launceston,2018,5,1/5/18,92783,0,92783
Launceston,2018,6,1/6/18,91460,0,91460
Launceston,2018,7,1/7/18,114793,0,114793
Launceston,2018,8,1/8/18,94629,0,94629
Launceston,2018,9,1/9/18,100600,0,100600
Launceston,2018,10,1/10/18,114947,0,114947
Launceston,2018,11,1/11/18,117220,0,117220
Launceston,2018,12,1/12/18,138791,0,138791
Launceston,2019,1,1/1/19,149841,0,149841
Launceston,2019,2,1/2/19,117262,0,117262
Mackay,2009,1,1/1/09,79707,0,79707
Mackay,2009,2,1/2/09,67954,0,67954
Mackay,2009,3,1/3/09,75713,0,75713
Mackay,2009,4,1/4/09,76795,0,76795
Mackay,2009,5,1/5/09,75905,0,75905
Mackay,2009,6,1/6/09,75327,0,75327
Mackay,2009,7,1/7/09,80654,0,80654
Mackay,2009,8,1/8/09,76128,0,76128
Mackay,2009,9,1/9/09,79124,0,79124
Mackay,2009,10,1/10/09,82009,0,82009
Mackay,2009,11,1/11/09,78372,0,78372
Mackay,2009,12,1/12/09,78001,0,78001
Mackay,2010,1,1/1/10,73251,0,73251
Mackay,2010,2,1/2/10,67801,0,67801
Mackay,2010,3,1/3/10,71371,0,71371
Mackay,2010,4,1/4/10,73491,0,73491
Mackay,2010,5,1/5/10,75614,0,75614
Mackay,2010,6,1/6/10,81422,0,81422
Mackay,2010,7,1/7/10,87430,0,87430
Mackay,2010,8,1/8/10,84081,0,84081
Mackay,2010,9,1/9/10,93091,0,93091
Mackay,2010,10,1/10/10,95938,0,95938
Mackay,2010,11,1/11/10,88065,0,88065
Mackay,2010,12,1/12/10,91512,0,91512
Mackay,2011,1,1/1/11,91439,0,91439
Mackay,2011,2,1/2/11,70712,0,70712
Mackay,2011,3,1/3/11,85846,0,85846
Mackay,2011,4,1/4/11,84174,0,84174
Mackay,2011,5,1/5/11,88720,0,88720
Mackay,2011,6,1/6/11,88164,0,88164
Mackay,2011,7,1/7/11,93581,0,93581
Mackay,2011,8,1/8/11,94890,0,94890
Mackay,2011,9,1/9/11,97626,0,97626
Mackay,2011,10,1/10/11,100744,0,100744
Mackay,2011,11,1/11/11,94528,0,94528
Mackay,2011,12,1/12/11,92177,0,92177
Mackay,2012,1,1/1/12,86488,0,86488
Mackay,2012,2,1/2/12,85726,0,85726
Mackay,2012,3,1/3/12,94071,0,94071
Mackay,2012,4,1/4/12,92142,0,92142
Mackay,2012,5,1/5/12,97105,0,97105
Mackay,2012,6,1/6/12,97069,0,97069
Mackay,2012,7,1/7/12,98838,0,98838
Mackay,2012,8,1/8/12,96619,0,96619
Mackay,2012,9,1/9/12,95863,0,95863
Mackay,2012,10,1/10/12,98533,0,98533
Mackay,2012,11,1/11/12,90641,0,90641
Mackay,2012,12,1/12/12,93148,0,93148
Mackay,2013,1,1/1/13,90419,0,90419
Mackay,2013,2,1/2/13,80480,0,80480
Mackay,2013,3,1/3/13,92017,0,92017
Mackay,2013,4,1/4/13,94576,0,94576
Mackay,2013,5,1/5/13,90397,0,90397
Mackay,2013,6,1/6/13,94400,0,94400
Mackay,2013,7,1/7/13,98238,0,98238
Mackay,2013,8,1/8/13,94332,0,94332
Mackay,2013,9,1/9/13,92710,0,92710
Mackay,2013,10,1/10/13,97062,0,97062
Mackay,2013,11,1/11/13,85349,0,85349
Mackay,2013,12,1/12/13,92614,0,92614
Mackay,2014,1,1/1/14,80872,0,80872
Mackay,2014,2,1/2/14,71238,0,71238
Mackay,2014,3,1/3/14,81108,0,81108
Mackay,2014,4,1/4/14,82634,0,82634
Mackay,2014,5,1/5/14,80113,0,80113
Mackay,2014,6,1/6/14,76918,0,76918
Mackay,2014,7,1/7/14,88615,0,88615
Mackay,2014,8,1/8/14,80851,0,80851
Mackay,2014,9,1/9/14,81841,0,81841
Mackay,2014,10,1/10/14,88065,0,88065
Mackay,2014,11,1/11/14,75993,0,75993
Mackay,2014,12,1/12/14,81715,0,81715
Mackay,2015,1,1/1/15,70552,0,70552
Mackay,2015,2,1/2/15,61847,0,61847
Mackay,2015,3,1/3/15,75432,0,75432
Mackay,2015,4,1/4/15,76218,0,76218
Mackay,2015,5,1/5/15,74597,0,74597
Mackay,2015,6,1/6/15,72628,0,72628
Mackay,2015,7,1/7/15,80366,0,80366
Mackay,2015,8,1/8/15,74958,0,74958
Mackay,2015,9,1/9/15,72682,0,72682
Mackay,2015,10,1/10/15,72495,0,72495
Mackay,2015,11,1/11/15,67809,0,67809
Mackay,2015,12,1/12/15,69348,0,69348
Mackay,2016,1,1/1/16,59313,0,59313
Mackay,2016,2,1/2/16,56299,0,56299
Mackay,2016,3,1/3/16,66480,0,66480
Mackay,2016,4,1/4/16,65065,0,65065
Mackay,2016,5,1/5/16,65847,0,65847
Mackay,2016,6,1/6/16,64408,0,64408
Mackay,2016,7,1/7/16,67159,0,67159
Mackay,2016,8,1/8/16,65440,0,65440
Mackay,2016,9,1/9/16,65815,0,65815
Mackay,2016,10,1/10/16,66427,0,66427
Mackay,2016,11,1/11/16,61928,0,61928
Mackay,2016,12,1/12/16,63472,0,63472
Mackay,2017,1,1/1/17,55899,0,55899
Mackay,2017,2,1/2/17,54192,0,54192
Mackay,2017,3,1/3/17,56272,0,56272
Mackay,2017,4,1/4/17,65238,0,65238
Mackay,2017,5,1/5/17,64671,0,64671
Mackay,2017,6,1/6/17,64241,0,64241
Mackay,2017,7,1/7/17,66903,0,66903
Mackay,2017,8,1/8/17,65317,0,65317
Mackay,2017,9,1/9/17,70075,0,70075
Mackay,2017,10,1/10/17,69940,0,69940
Mackay,2017,11,1/11/17,64685,0,64685
Mackay,2017,12,1/12/17,65570,0,65570
Mackay,2018,1,1/1/18,61385,0,61385
Mackay,2018,2,1/2/18,56399,0,56399
Mackay,2018,3,1/3/18,68038,0,68038
Mackay,2018,4,1/4/18,62308,0,62308
Mackay,2018,5,1/5/18,68193,0,68193
Mackay,2018,6,1/6/18,64327,0,64327
Mackay,2018,7,1/7/18,77497,0,77497
Mackay,2018,8,1/8/18,75262,0,75262
Mackay,2018,9,1/9/18,69217,0,69217
Mackay,2018,10,1/10/18,70749,0,70749
Mackay,2018,11,1/11/18,67457,0,67457
Mackay,2018,12,1/12/18,67134,0,67134
Mackay,2019,1,1/1/19,62388,0,62388
Mackay,2019,2,1/2/19,59493,0,59493
Melbourne,2009,1,1/1/09,1689135,464486,2153621
Melbourne,2009,2,1/2/09,1485948,378940,1864888
Melbourne,2009,3,1/3/09,1697698,398919,2096617
Melbourne,2009,4,1/4/09,1649779,412382,2062161
Melbourne,2009,5,1/5/09,1551212,371483,1922695
Melbourne,2009,6,1/6/09,1479867,396792,1876659
Melbourne,2009,7,1/7/09,1647597,437524,2085121
Melbourne,2009,8,1/8/09,1650922,409169,2060091
Melbourne,2009,9,1/9/09,1686877,442531,2129408
Melbourne,2009,10,1/10/09,1776341,456969,2233310
Melbourne,2009,11,1/11/09,1740366,447407,2187773
Melbourne,2009,12,1/12/09,1699476,513750,2213226
Melbourne,2010,1,1/1/10,1683740,528510,2212250
Melbourne,2010,2,1/2/10,1611297,448201,2059498
Melbourne,2010,3,1/3/10,1826339,470925,2297264
Melbourne,2010,4,1/4/10,1769927,440740,2210667
Melbourne,2010,5,1/5/10,1682667,409912,2092579
Melbourne,2010,6,1/6/10,1670623,466182,2136805
Melbourne,2010,7,1/7/10,1857806,515612,2373418
Melbourne,2010,8,1/8/10,1833698,473354,2307052
Melbourne,2010,9,1/9/10,1876531,515192,2391723
Melbourne,2010,10,1/10/10,1955778,526288,2482066
Melbourne,2010,11,1/11/10,1862769,491203,2353972
Melbourne,2010,12,1/12/10,1891078,586392,2477470
Melbourne,2011,1,1/1/11,1827537,627843,2455380
Melbourne,2011,2,1/2/11,1610177,495121,2105298
Melbourne,2011,3,1/3/11,1853100,481748,2334848
Melbourne,2011,4,1/4/11,1830836,524810,2355646
Melbourne,2011,5,1/5/11,1748694,478669,2227363
Melbourne,2011,6,1/6/11,1601351,497247,2098598
Melbourne,2011,7,1/7/11,1808782,571817,2380599
Melbourne,2011,8,1/8/11,1752139,521423,2273562
Melbourne,2011,9,1/9/11,1744591,545803,2290394
Melbourne,2011,10,1/10/11,1844756,553442,2398198
Melbourne,2011,11,1/11/11,1794580,537546,2332126
Melbourne,2011,12,1/12/11,1790003,625489,2415492
Melbourne,2012,1,1/1/12,1812320,660137,2472457
Melbourne,2012,2,1/2/12,1651982,524223,2176205
Melbourne,2012,3,1/3/12,1868393,547293,2415686
Melbourne,2012,4,1/4/12,1790839,537975,2328814
Melbourne,2012,5,1/5/12,1745690,489333,2235023
Melbourne,2012,6,1/6/12,1694538,543399,2237937
Melbourne,2012,7,1/7/12,1898849,578084,2476933
Melbourne,2012,8,1/8/12,1864840,547251,2412091
Melbourne,2012,9,1/9/12,1886222,576431,2462653
Melbourne,2012,10,1/10/12,1984521,585162,2569683
Melbourne,2012,11,1/11/12,1991497,571059,2562556
Melbourne,2012,12,1/12/12,1908659,658895,2567554
Melbourne,2013,1,1/1/13,1909129,673592,2582721
Melbourne,2013,2,1/2/13,1699662,535435,2235097
Melbourne,2013,3,1/3/13,1953940,582585,2536525
Melbourne,2013,4,1/4/13,1881653,563156,2444809
Melbourne,2013,5,1/5/13,1782664,532377,2315041
Melbourne,2013,6,1/6/13,1743116,583479,2326595
Melbourne,2013,7,1/7/13,2034584,649721,2684305
Melbourne,2013,8,1/8/13,1951818,624168,2575986
Melbourne,2013,9,1/9/13,1901804,622717,2524521
Melbourne,2013,10,1/10/13,2069549,624860,2694409
Melbourne,2013,11,1/11/13,1972080,593432,2565512
Melbourne,2013,12,1/12/13,2008285,726621,2734906
Melbourne,2014,1,1/1/14,1988112,751678,2739790
Melbourne,2014,2,1/2/14,1754473,589200,2343673
Melbourne,2014,3,1/3/14,1971872,599597,2571469
Melbourne,2014,4,1/4/14,1936458,645499,2581957
Melbourne,2014,5,1/5/14,1833195,599694,2432889
Melbourne,2014,6,1/6/14,1807665,638937,2446602
Melbourne,2014,7,1/7/14,2015975,725467,2741442
Melbourne,2014,8,1/8/14,1955141,664402,2619543
Melbourne,2014,9,1/9/14,1941656,676862,2618518
Melbourne,2014,10,1/10/14,2148535,694570,2843105
Melbourne,2014,11,1/11/14,1996097,664073,2660170
Melbourne,2014,12,1/12/14,2015148,772487,2787635
Melbourne,2015,1,1/1/15,1952929,808207,2761136
Melbourne,2015,2,1/2/15,1792634,678328,2470962
Melbourne,2015,3,1/3/15,2044947,716520,2761467
Melbourne,2015,4,1/4/15,1961204,684751,2645955
Melbourne,2015,5,1/5/15,1872841,636936,2509777
Melbourne,2015,6,1/6/15,1827552,688338,2515890
Melbourne,2015,7,1/7/15,2131018,779103,2910121
Melbourne,2015,8,1/8/15,1981994,732905,2714899
Melbourne,2015,9,1/9/15,2006378,744426,2750804
Melbourne,2015,10,1/10/15,2169657,775334,2944991
Melbourne,2015,11,1/11/15,2078813,736825,2815638
Melbourne,2015,12,1/12/15,2110930,877643,2988573
Melbourne,2016,1,1/1/16,2041802,895294,2937096
Melbourne,2016,2,1/2/16,1920964,764234,2685198
Melbourne,2016,3,1/3/16,2111913,775782,2887695
Melbourne,2016,4,1/4/16,2010463,741474,2751937
Melbourne,2016,5,1/5/16,1944878,690498,2635376
Melbourne,2016,6,1/6/16,1917216,765416,2682632
Melbourne,2016,7,1/7/16,2151629,876022,3027651
Melbourne,2016,8,1/8/16,2015286,780834,2796120
Melbourne,2016,9,1/9/16,2115140,803333,2918473
Melbourne,2016,10,1/10/16,2193718,813439,3007157
Melbourne,2016,11,1/11/16,2147878,780219,2928097
Melbourne,2016,12,1/12/16,2161716,956041,3117757
Melbourne,2017,1,1/1/17,2128087,980100,3108187
Melbourne,2017,2,1/2/17,1861829,778338,2640167
Melbourne,2017,3,1/3/17,2137402,785165,2922567
Melbourne,2017,4,1/4/17,2084709,848207,2932916
Melbourne,2017,5,1/5/17,1976227,740299,2716526
Melbourne,2017,6,1/6/17,1954427,807461,2761888
Melbourne,2017,7,1/7/17,2210661,926881,3137542
Melbourne,2017,8,1/8/17,2059224,840515,2899739
Melbourne,2017,9,1/9/17,2109572,866933,2976505
Melbourne,2017,10,1/10/17,2290350,883230,3173580
Melbourne,2017,11,1/11/17,2221211,851387,3072598
Melbourne,2017,12,1/12/17,2202040,1015266,3217306
Melbourne,2018,1,1/1/18,2170968,1020724,3191692
Melbourne,2018,2,1/2/18,1927548,871187,2798735
Melbourne,2018,3,1/3/18,2226583,909908,3136491
Melbourne,2018,4,1/4/18,2136018,894262,3030280
Melbourne,2018,5,1/5/18,2007811,800820,2808631
Melbourne,2018,6,1/6/18,1972614,902957,2875571
Melbourne,2018,7,1/7/18,2265448,994216,3259664
Melbourne,2018,8,1/8/18,2143001,938116,3081117
Melbourne,2018,9,1/9/18,2131638,951501,3083139
Melbourne,2018,10,1/10/18,2309063,960308,3269371
Melbourne,2018,11,1/11/18,2224829,935091,3159920
Melbourne,2018,12,1/12/18,2177224,1044794,3222018
Melbourne,2019,1,1/1/19,2188064,1070087,3258151
Melbourne,2019,2,1/2/19,1952723,889344,2842067
Newcastle,2009,1,1/1/09,103394,0,103394
Newcastle,2009,2,1/2/09,85201,0,85201
Newcastle,2009,3,1/3/09,98019,0,98019
Newcastle,2009,4,1/4/09,97912,0,97912
Newcastle,2009,5,1/5/09,94768,0,94768
Newcastle,2009,6,1/6/09,84566,0,84566
Newcastle,2009,7,1/7/09,96489,0,96489
Newcastle,2009,8,1/8/09,94027,0,94027
Newcastle,2009,9,1/9/09,93290,0,93290
Newcastle,2009,10,1/10/09,100959,0,100959
Newcastle,2009,11,1/11/09,96301,0,96301
Newcastle,2009,12,1/12/09,92811,0,92811
Newcastle,2010,1,1/1/10,91421,0,91421
Newcastle,2010,2,1/2/10,84654,0,84654
Newcastle,2010,3,1/3/10,98699,0,98699
Newcastle,2010,4,1/4/10,96872,0,96872
Newcastle,2010,5,1/5/10,92294,0,92294
Newcastle,2010,6,1/6/10,89575,0,89575
Newcastle,2010,7,1/7/10,101983,0,101983
Newcastle,2010,8,1/8/10,97481,0,97481
Newcastle,2010,9,1/9/10,102135,0,102135
Newcastle,2010,10,1/10/10,111975,0,111975
Newcastle,2010,11,1/11/10,107502,0,107502
Newcastle,2010,12,1/12/10,111376,0,111376
Newcastle,2011,1,1/1/11,105668,0,105668
Newcastle,2011,2,1/2/11,88141,0,88141
Newcastle,2011,3,1/3/11,101958,0,101958
Newcastle,2011,4,1/4/11,101326,0,101326
Newcastle,2011,5,1/5/11,96319,0,96319
Newcastle,2011,6,1/6/11,85438,0,85438
Newcastle,2011,7,1/7/11,100865,0,100865
Newcastle,2011,8,1/8/11,98732,0,98732
Newcastle,2011,9,1/9/11,101285,0,101285
Newcastle,2011,10,1/10/11,108960,0,108960
Newcastle,2011,11,1/11/11,101660,0,101660
Newcastle,2011,12,1/12/11,100807,0,100807
Newcastle,2012,1,1/1/12,100810,0,100810
Newcastle,2012,2,1/2/12,90937,0,90937
Newcastle,2012,3,1/3/12,104070,0,104070
Newcastle,2012,4,1/4/12,96764,0,96764
Newcastle,2012,5,1/5/12,98493,0,98493
Newcastle,2012,6,1/6/12,90793,0,90793
Newcastle,2012,7,1/7/12,98741,0,98741
Newcastle,2012,8,1/8/12,96318,0,96318
Newcastle,2012,9,1/9/12,100083,0,100083
Newcastle,2012,10,1/10/12,104490,0,104490
Newcastle,2012,11,1/11/12,102998,0,102998
Newcastle,2012,12,1/12/12,99926,0,99926
Newcastle,2013,1,1/1/13,98439,0,98439
Newcastle,2013,2,1/2/13,87684,0,87684
Newcastle,2013,3,1/3/13,101633,0,101633
Newcastle,2013,4,1/4/13,102297,0,102297
Newcastle,2013,5,1/5/13,94671,0,94671
Newcastle,2013,6,1/6/13,90777,0,90777
Newcastle,2013,7,1/7/13,104093,0,104093
Newcastle,2013,8,1/8/13,100632,0,100632
Newcastle,2013,9,1/9/13,103907,0,103907
Newcastle,2013,10,1/10/13,109133,0,109133
Newcastle,2013,11,1/11/13,107777,0,107777
Newcastle,2013,12,1/12/13,105474,0,105474
Newcastle,2014,1,1/1/14,101666,0,101666
Newcastle,2014,2,1/2/14,86129,0,86129
Newcastle,2014,3,1/3/14,100653,0,100653
Newcastle,2014,4,1/4/14,95541,0,95541
Newcastle,2014,5,1/5/14,94941,0,94941
Newcastle,2014,6,1/6/14,90266,0,90266
Newcastle,2014,7,1/7/14,101529,0,101529
Newcastle,2014,8,1/8/14,97284,0,97284
Newcastle,2014,9,1/9/14,100260,0,100260
Newcastle,2014,10,1/10/14,107166,0,107166
Newcastle,2014,11,1/11/14,97264,0,97264
Newcastle,2014,12,1/12/14,95844,0,95844
Newcastle,2015,1,1/1/15,93178,0,93178
Newcastle,2015,2,1/2/15,80225,0,80225
Newcastle,2015,3,1/3/15,93900,0,93900
Newcastle,2015,4,1/4/15,92850,0,92850
Newcastle,2015,5,1/5/15,93417,0,93417
Newcastle,2015,6,1/6/15,90921,0,90921
Newcastle,2015,7,1/7/15,103879,0,103879
Newcastle,2015,8,1/8/15,95725,0,95725
Newcastle,2015,9,1/9/15,100315,0,100315
Newcastle,2015,10,1/10/15,106340,0,106340
Newcastle,2015,11,1/11/15,99412,0,99412
Newcastle,2015,12,1/12/15,100512,0,100512
Newcastle,2016,1,1/1/16,95227,0,95227
Newcastle,2016,2,1/2/16,89433,0,89433
Newcastle,2016,3,1/3/16,101092,0,101092
Newcastle,2016,4,1/4/16,94806,0,94806
Newcastle,2016,5,1/5/16,95929,0,95929
Newcastle,2016,6,1/6/16,92194,0,92194
Newcastle,2016,7,1/7/16,106042,0,106042
Newcastle,2016,8,1/8/16,100869,0,100869
Newcastle,2016,9,1/9/16,108062,0,108062
Newcastle,2016,10,1/10/16,113825,0,113825
Newcastle,2016,11,1/11/16,105703,0,105703
Newcastle,2016,12,1/12/16,107930,0,107930
Newcastle,2017,1,1/1/17,108376,0,108376
Newcastle,2017,2,1/2/17,89924,0,89924
Newcastle,2017,3,1/3/17,104459,0,104459
Newcastle,2017,4,1/4/17,108573,0,108573
Newcastle,2017,5,1/5/17,100066,0,100066
Newcastle,2017,6,1/6/17,95732,0,95732
Newcastle,2017,7,1/7/17,108616,0,108616
Newcastle,2017,8,1/8/17,99173,0,99173
Newcastle,2017,9,1/9/17,110149,0,110149
Newcastle,2017,10,1/10/17,116130,0,116130
Newcastle,2017,11,1/11/17,111413,0,111413
Newcastle,2017,12,1/12/17,112700,0,112700
Newcastle,2018,1,1/1/18,104773,0,104773
Newcastle,2018,2,1/2/18,92772,0,92772
Newcastle,2018,3,1/3/18,107098,0,107098
Newcastle,2018,4,1/4/18,105270,0,105270
Newcastle,2018,5,1/5/18,101884,0,101884
Newcastle,2018,6,1/6/18,95026,0,95026
Newcastle,2018,7,1/7/18,109087,0,109087
Newcastle,2018,8,1/8/18,103413,0,103413
Newcastle,2018,9,1/9/18,101570,0,101570
Newcastle,2018,10,1/10/18,111884,0,111884
Newcastle,2018,11,1/11/18,112039,574,112613
Newcastle,2018,12,1/12/18,106313,2166,108479
Newcastle,2019,1,1/1/19,106963,2853,109816
Newcastle,2019,2,1/2/19,91797,1094,92891
Perth,2009,1,1/1/09,572528,260880,833408
Perth,2009,2,1/2/09,487285,190896,678181
Perth,2009,3,1/3/09,580649,203169,783818
Perth,2009,4,1/4/09,578264,223465,801729
Perth,2009,5,1/5/09,550436,196896,747332
Perth,2009,6,1/6/09,524096,213201,737297
Perth,2009,7,1/7/09,604014,240433,844447
Perth,2009,8,1/8/09,573336,217632,790968
Perth,2009,9,1/9/09,588922,242895,831817
Perth,2009,10,1/10/09,616567,258197,874764
Perth,2009,11,1/11/09,577248,243717,820965
Perth,2009,12,1/12/09,587692,283356,871048
Perth,2010,1,1/1/10,574900,295381,870281
Perth,2010,2,1/2/10,518406,225992,744398
Perth,2010,3,1/3/10,619243,251849,871092
Perth,2010,4,1/4/10,605279,244898,850177
Perth,2010,5,1/5/10,574110,218752,792862
Perth,2010,6,1/6/10,570994,258775,829769
Perth,2010,7,1/7/10,640536,281742,922278
Perth,2010,8,1/8/10,612874,249745,862619
Perth,2010,9,1/9/10,632695,273925,906620
Perth,2010,10,1/10/10,670675,282272,952947
Perth,2010,11,1/11/10,637763,252043,889806
Perth,2010,12,1/12/10,662378,298335,960713
Perth,2011,1,1/1/11,633375,323861,957236
Perth,2011,2,1/2/11,550219,241861,792080
Perth,2011,3,1/3/11,661614,248100,909714
Perth,2011,4,1/4/11,661530,274092,935622
Perth,2011,5,1/5/11,665469,253549,919018
Perth,2011,6,1/6/11,615319,265631,880950
Perth,2011,7,1/7/11,707274,306560,1013834
Perth,2011,8,1/8/11,696088,267113,963201
Perth,2011,9,1/9/11,691838,285045,976883
Perth,2011,10,1/10/11,709098,301321,1010419
Perth,2011,11,1/11/11,716150,270318,986468
Perth,2011,12,1/12/11,708058,312017,1020075
Perth,2012,1,1/1/12,713610,336792,1050402
Perth,2012,2,1/2/12,654247,261096,915343
Perth,2012,3,1/3/12,741660,281963,1023623
Perth,2012,4,1/4/12,736077,300178,1036255
Perth,2012,5,1/5/12,737858,258297,996155
Perth,2012,6,1/6/12,715078,289058,1004136
Perth,2012,7,1/7/12,799183,323088,1122271
Perth,2012,8,1/8/12,775021,286810,1061831
Perth,2012,9,1/9/12,763836,310760,1074596
Perth,2012,10,1/10/12,832739,330018,1162757
Perth,2012,11,1/11/12,770604,293318,1063922
Perth,2012,12,1/12/12,759658,347390,1107048
Perth,2013,1,1/1/13,756864,367962,1124826
Perth,2013,2,1/2/13,642458,278377,920835
Perth,2013,3,1/3/13,761463,303379,1064842
Perth,2013,4,1/4/13,775099,306529,1081628
Perth,2013,5,1/5/13,753255,291548,1044803
Perth,2013,6,1/6/13,700089,302421,1002510
Perth,2013,7,1/7/13,810895,356942,1167837
Perth,2013,8,1/8/13,747462,320500,1067962
Perth,2013,9,1/9/13,747305,335673,1082978
Perth,2013,10,1/10/13,807825,348468,1156293
Perth,2013,11,1/11/13,725938,310162,1036100
Perth,2013,12,1/12/13,753219,397879,1151098
Perth,2014,1,1/1/14,758600,433321,1191921
Perth,2014,2,1/2/14,650752,304688,955440
Perth,2014,3,1/3/14,731594,315230,1046824
Perth,2014,4,1/4/14,767264,358776,1126040
Perth,2014,5,1/5/14,706266,301123,1007389
Perth,2014,6,1/6/14,673029,316799,989828
Perth,2014,7,1/7/14,769306,384777,1154083
Perth,2014,8,1/8/14,719835,330424,1050259
Perth,2014,9,1/9/14,729205,361367,1090572
Perth,2014,10,1/10/14,800553,363136,1163689
Perth,2014,11,1/11/14,712059,315336,1027395
Perth,2014,12,1/12/14,740056,395430,1135486
Perth,2015,1,1/1/15,710044,423008,1133052
Perth,2015,2,1/2/15,614778,314338,929116
Perth,2015,3,1/3/15,710527,327872,1038399
Perth,2015,4,1/4/15,723283,342258,1065541
Perth,2015,5,1/5/15,665346,301409,966755
Perth,2015,6,1/6/15,650149,325622,975771
Perth,2015,7,1/7/15,764653,386492,1151145
Perth,2015,8,1/8/15,685115,335142,1020257
Perth,2015,9,1/9/15,699543,354427,1053970
Perth,2015,10,1/10/15,748228,361122,1109350
Perth,2015,11,1/11/15,699179,317970,1017149
Perth,2015,12,1/12/15,730687,403173,1133860
Perth,2016,1,1/1/16,688600,433983,1122583
Perth,2016,2,1/2/16,605234,333991,939225
Perth,2016,3,1/3/16,695807,343473,1039280
Perth,2016,4,1/4/16,683411,353191,1036602
Perth,2016,5,1/5/16,648126,307965,956091
Perth,2016,6,1/6/16,636356,340182,976538
Perth,2016,7,1/7/16,704946,403378,1108324
Perth,2016,8,1/8/16,664744,341209,1005953
Perth,2016,9,1/9/16,693449,379212,1072661
Perth,2016,10,1/10/16,712408,378835,1091243
Perth,2016,11,1/11/16,677612,340917,1018529
Perth,2016,12,1/12/16,714793,422839,1137632
Perth,2017,1,1/1/17,690641,436652,1127293
Perth,2017,2,1/2/17,569834,328014,897848
Perth,2017,3,1/3/17,663410,343748,1007158
Perth,2017,4,1/4/17,668963,379485,1048448
Perth,2017,5,1/5/17,642626,321134,963760
Perth,2017,6,1/6/17,622626,348410,971036
Perth,2017,7,1/7/17,701703,394005,1095708
Perth,2017,8,1/8/17,658247,345460,1003707
Perth,2017,9,1/9/17,665713,372232,1037945
Perth,2017,10,1/10/17,714719,376731,1091450
Perth,2017,11,1/11/17,681111,330684,1011795
Perth,2017,12,1/12/17,705432,408912,1114344
Perth,2018,1,1/1/18,693490,420932,1114422
Perth,2018,2,1/2/18,587505,320699,908204
Perth,2018,3,1/3/18,687018,351509,1038527
Perth,2018,4,1/4/18,684014,356243,1040257
Perth,2018,5,1/5/18,664794,321592,986386
Perth,2018,6,1/6/18,620514,355647,976161
Perth,2018,7,1/7/18,717060,396045,1113105
Perth,2018,8,1/8/18,663424,357102,1020526
Perth,2018,9,1/9/18,684915,370754,1055669
Perth,2018,10,1/10/18,731068,360327,1091395
Perth,2018,11,1/11/18,688113,337264,1025377
Perth,2018,12,1/12/18,689980,417857,1107837
Perth,2019,1,1/1/19,688800,422061,1110861
Perth,2019,2,1/2/19,582619,324918,907537
Proserpine,2009,1,1/1/09,19787,0,19787
Proserpine,2009,2,1/2/09,16058,0,16058
Proserpine,2009,3,1/3/09,18291,0,18291
Proserpine,2009,4,1/4/09,18014,0,18014
Proserpine,2009,5,1/5/09,17453,0,17453
Proserpine,2009,6,1/6/09,17200,0,17200
Proserpine,2009,7,1/7/09,18800,0,18800
Proserpine,2009,8,1/8/09,19540,0,19540
Proserpine,2009,9,1/9/09,19168,0,19168
Proserpine,2009,10,1/10/09,19749,0,19749
Proserpine,2009,11,1/11/09,18861,0,18861
Proserpine,2009,12,1/12/09,17943,0,17943
Proserpine,2010,1,1/1/10,17298,0,17298
Proserpine,2010,2,1/2/10,15862,0,15862
Proserpine,2010,3,1/3/10,15774,0,15774
Proserpine,2010,4,1/4/10,17205,0,17205
Proserpine,2010,5,1/5/10,16519,0,16519
Proserpine,2010,6,1/6/10,16900,0,16900
Proserpine,2010,7,1/7/10,18417,0,18417
Proserpine,2010,8,1/8/10,18548,0,18548
Proserpine,2010,9,1/9/10,18227,0,18227
Proserpine,2010,10,1/10/10,19369,0,19369
Proserpine,2010,11,1/11/10,18447,0,18447
Proserpine,2010,12,1/12/10,17950,0,17950
Proserpine,2011,1,1/1/11,17574,0,17574
Proserpine,2011,2,1/2/11,12686,0,12686
Proserpine,2011,3,1/3/11,15519,0,15519
Proserpine,2011,4,1/4/11,16480,0,16480
Proserpine,2011,5,1/5/11,16223,0,16223
Proserpine,2011,6,1/6/11,15996,0,15996
Proserpine,2011,7,1/7/11,18173,0,18173
Proserpine,2011,8,1/8/11,18733,0,18733
Proserpine,2011,9,1/9/11,18646,0,18646
Proserpine,2011,10,1/10/11,19427,0,19427
Proserpine,2011,11,1/11/11,17979,0,17979
Proserpine,2011,12,1/12/11,17506,0,17506
Proserpine,2012,1,1/1/12,17497,0,17497
Proserpine,2012,2,1/2/12,14088,0,14088
Proserpine,2012,3,1/3/12,17843,0,17843
Proserpine,2012,4,1/4/12,19416,0,19416
Proserpine,2012,5,1/5/12,17812,0,17812
Proserpine,2012,6,1/6/12,18463,0,18463
Proserpine,2012,7,1/7/12,21613,0,21613
Proserpine,2012,8,1/8/12,20487,0,20487
Proserpine,2012,9,1/9/12,20713,0,20713
Proserpine,2012,10,1/10/12,22739,0,22739
Proserpine,2012,11,1/11/12,21591,0,21591
Proserpine,2012,12,1/12/12,20551,0,20551
Proserpine,2013,1,1/1/13,20583,0,20583
Proserpine,2013,2,1/2/13,15730,0,15730
Proserpine,2013,3,1/3/13,17361,0,17361
Proserpine,2013,4,1/4/13,19115,0,19115
Proserpine,2013,5,1/5/13,16908,0,16908
Proserpine,2013,6,1/6/13,17661,0,17661
Proserpine,2013,7,1/7/13,21195,0,21195
Proserpine,2013,8,1/8/13,20312,0,20312
Proserpine,2013,9,1/9/13,21051,0,21051
Proserpine,2013,10,1/10/13,22250,0,22250
Proserpine,2013,11,1/11/13,20635,0,20635
Proserpine,2013,12,1/12/13,21601,0,21601
Proserpine,2014,1,1/1/14,20500,0,20500
Proserpine,2014,2,1/2/14,16288,0,16288
Proserpine,2014,3,1/3/14,18131,0,18131
Proserpine,2014,4,1/4/14,22114,0,22114
Proserpine,2014,5,1/5/14,20307,0,20307
Proserpine,2014,6,1/6/14,20083,0,20083
Proserpine,2014,7,1/7/14,24036,0,24036
Proserpine,2014,8,1/8/14,23583,0,23583
Proserpine,2014,9,1/9/14,24230,0,24230
Proserpine,2014,10,1/10/14,26030,0,26030
Proserpine,2014,11,1/11/14,23990,0,23990
Proserpine,2014,12,1/12/14,25046,0,25046
Proserpine,2015,1,1/1/15,24786,0,24786
Proserpine,2015,2,1/2/15,20793,0,20793
Proserpine,2015,3,1/3/15,21229,0,21229
Proserpine,2015,4,1/4/15,24759,0,24759
Proserpine,2015,5,1/5/15,20734,0,20734
Proserpine,2015,6,1/6/15,21632,0,21632
Proserpine,2015,7,1/7/15,30707,0,30707
Proserpine,2015,8,1/8/15,29885,0,29885
Proserpine,2015,9,1/9/15,30482,0,30482
Proserpine,2015,10,1/10/15,32223,0,32223
Proserpine,2015,11,1/11/15,30212,0,30212
Proserpine,2015,12,1/12/15,31687,0,31687
Proserpine,2016,1,1/1/16,31132,0,31132
Proserpine,2016,2,1/2/16,27290,0,27290
Proserpine,2016,3,1/3/16,27934,0,27934
Proserpine,2016,4,1/4/16,27430,0,27430
Proserpine,2016,5,1/5/16,24224,0,24224
Proserpine,2016,6,1/6/16,24824,0,24824
Proserpine,2016,7,1/7/16,29183,0,29183
Proserpine,2016,8,1/8/16,29028,0,29028
Proserpine,2016,9,1/9/16,29677,0,29677
Proserpine,2016,10,1/10/16,31697,0,31697
Proserpine,2016,11,1/11/16,27657,0,27657
Proserpine,2016,12,1/12/16,32762,0,32762
Proserpine,2017,1,1/1/17,31637,0,31637
Proserpine,2017,2,1/2/17,24321,0,24321
Proserpine,2017,3,1/3/17,23228,0,23228
Proserpine,2017,4,1/4/17,30614,0,30614
Proserpine,2017,5,1/5/17,30248,0,30248
Proserpine,2017,6,1/6/17,33020,0,33020
Proserpine,2017,7,1/7/17,41023,0,41023
Proserpine,2017,8,1/8/17,39456,0,39456
Proserpine,2017,9,1/9/17,42010,0,42010
Proserpine,2017,10,1/10/17,43647,0,43647
Proserpine,2017,11,1/11/17,41306,0,41306
Proserpine,2017,12,1/12/17,45061,0,45061
Proserpine,2018,1,1/1/18,44938,0,44938
Proserpine,2018,2,1/2/18,37254,0,37254
Proserpine,2018,3,1/3/18,36965,0,36965
Proserpine,2018,4,1/4/18,36112,0,36112
Proserpine,2018,5,1/5/18,31221,0,31221
Proserpine,2018,6,1/6/18,30965,0,30965
Proserpine,2018,7,1/7/18,39968,0,39968
Proserpine,2018,8,1/8/18,37955,0,37955
Proserpine,2018,9,1/9/18,38293,0,38293
Proserpine,2018,10,1/10/18,41867,0,41867
Proserpine,2018,11,1/11/18,35848,0,35848
Proserpine,2018,12,1/12/18,37189,0,37189
Proserpine,2019,1,1/1/19,38331,0,38331
Proserpine,2019,2,1/2/19,29292,0,29292
Rockhampton,2009,1,1/1/09,55654,0,55654
Rockhampton,2009,2,1/2/09,52148,0,52148
Rockhampton,2009,3,1/3/09,61228,0,61228
Rockhampton,2009,4,1/4/09,60084,0,60084
Rockhampton,2009,5,1/5/09,64202,0,64202
Rockhampton,2009,6,1/6/09,62058,0,62058
Rockhampton,2009,7,1/7/09,68050,0,68050
Rockhampton,2009,8,1/8/09,65941,0,65941
Rockhampton,2009,9,1/9/09,64178,0,64178
Rockhampton,2009,10,1/10/09,64903,0,64903
Rockhampton,2009,11,1/11/09,61914,0,61914
Rockhampton,2009,12,1/12/09,62977,0,62977
Rockhampton,2010,1,1/1/10,55477,0,55477
Rockhampton,2010,2,1/2/10,58127,0,58127
Rockhampton,2010,3,1/3/10,63175,0,63175
Rockhampton,2010,4,1/4/10,65347,0,65347
Rockhampton,2010,5,1/5/10,63603,0,63603
Rockhampton,2010,6,1/6/10,63712,0,63712
Rockhampton,2010,7,1/7/10,64941,0,64941
Rockhampton,2010,8,1/8/10,66111,0,66111
Rockhampton,2010,9,1/9/10,69657,0,69657
Rockhampton,2010,10,1/10/10,69640,0,69640
Rockhampton,2010,11,1/11/10,67980,0,67980
Rockhampton,2010,12,1/12/10,69442,0,69442
Rockhampton,2011,1,1/1/11,10385,0,10385
Rockhampton,2011,2,1/2/11,49801,0,49801
Rockhampton,2011,3,1/3/11,62278,0,62278
Rockhampton,2011,4,1/4/11,61645,0,61645
Rockhampton,2011,5,1/5/11,64261,0,64261
Rockhampton,2011,6,1/6/11,63664,0,63664
Rockhampton,2011,7,1/7/11,66912,0,66912
Rockhampton,2011,8,1/8/11,64887,0,64887
Rockhampton,2011,9,1/9/11,66844,0,66844
Rockhampton,2011,10,1/10/11,66160,0,66160
Rockhampton,2011,11,1/11/11,63216,0,63216
Rockhampton,2011,12,1/12/11,60974,0,60974
Rockhampton,2012,1,1/1/12,55531,0,55531
Rockhampton,2012,2,1/2/12,55938,0,55938
Rockhampton,2012,3,1/3/12,64688,0,64688
Rockhampton,2012,4,1/4/12,57763,0,57763
Rockhampton,2012,5,1/5/12,65553,0,65553
Rockhampton,2012,6,1/6/12,62167,0,62167
Rockhampton,2012,7,1/7/12,65993,0,65993
Rockhampton,2012,8,1/8/12,64658,0,64658
Rockhampton,2012,9,1/9/12,63168,0,63168
Rockhampton,2012,10,1/10/12,65962,0,65962
Rockhampton,2012,11,1/11/12,61360,0,61360
Rockhampton,2012,12,1/12/12,57696,0,57696
Rockhampton,2013,1,1/1/13,51121,0,51121
Rockhampton,2013,2,1/2/13,47229,0,47229
Rockhampton,2013,3,1/3/13,59935,0,59935
Rockhampton,2013,4,1/4/13,59603,0,59603
Rockhampton,2013,5,1/5/13,57483,0,57483
Rockhampton,2013,6,1/6/13,56893,0,56893
Rockhampton,2013,7,1/7/13,64671,0,64671
Rockhampton,2013,8,1/8/13,62255,0,62255
Rockhampton,2013,9,1/9/13,59624,0,59624
Rockhampton,2013,10,1/10/13,63772,0,63772
Rockhampton,2013,11,1/11/13,56824,0,56824
Rockhampton,2013,12,1/12/13,57092,0,57092
Rockhampton,2014,1,1/1/14,49213,0,49213
Rockhampton,2014,2,1/2/14,46864,0,46864
Rockhampton,2014,3,1/3/14,55724,0,55724
Rockhampton,2014,4,1/4/14,54951,0,54951
Rockhampton,2014,5,1/5/14,55726,0,55726
Rockhampton,2014,6,1/6/14,54671,0,54671
Rockhampton,2014,7,1/7/14,58457,0,58457
Rockhampton,2014,8,1/8/14,55511,0,55511
Rockhampton,2014,9,1/9/14,57908,0,57908
Rockhampton,2014,10,1/10/14,58952,0,58952
Rockhampton,2014,11,1/11/14,52517,0,52517
Rockhampton,2014,12,1/12/14,50917,0,50917
Rockhampton,2015,1,1/1/15,44647,0,44647
Rockhampton,2015,2,1/2/15,39612,0,39612
Rockhampton,2015,3,1/3/15,55559,0,55559
Rockhampton,2015,4,1/4/15,52296,0,52296
Rockhampton,2015,5,1/5/15,55782,0,55782
Rockhampton,2015,6,1/6/15,52755,0,52755
Rockhampton,2015,7,1/7/15,56302,0,56302
Rockhampton,2015,8,1/8/15,51461,0,51461
Rockhampton,2015,9,1/9/15,52126,0,52126
Rockhampton,2015,10,1/10/15,53146,0,53146
Rockhampton,2015,11,1/11/15,51476,0,51476
Rockhampton,2015,12,1/12/15,49303,0,49303
Rockhampton,2016,1,1/1/16,40123,0,40123
Rockhampton,2016,2,1/2/16,42181,0,42181
Rockhampton,2016,3,1/3/16,48727,0,48727
Rockhampton,2016,4,1/4/16,48206,0,48206
Rockhampton,2016,5,1/5/16,50247,0,50247
Rockhampton,2016,6,1/6/16,49540,0,49540
Rockhampton,2016,7,1/7/16,50596,0,50596
Rockhampton,2016,8,1/8/16,50580,0,50580
Rockhampton,2016,9,1/9/16,52293,0,52293
Rockhampton,2016,10,1/10/16,50874,0,50874
Rockhampton,2016,11,1/11/16,49766,0,49766
Rockhampton,2016,12,1/12/16,51114,0,51114
Rockhampton,2017,1,1/1/17,41830,0,41830
Rockhampton,2017,2,1/2/17,41992,0,41992
Rockhampton,2017,3,1/3/17,49463,0,49463
Rockhampton,2017,4,1/4/17,30107,0,30107
Rockhampton,2017,5,1/5/17,48829,0,48829
Rockhampton,2017,6,1/6/17,48472,0,48472
Rockhampton,2017,7,1/7/17,53060,0,53060
Rockhampton,2017,8,1/8/17,49997,0,49997
Rockhampton,2017,9,1/9/17,49988,0,49988
Rockhampton,2017,10,1/10/17,50884,0,50884
Rockhampton,2017,11,1/11/17,46653,0,46653
Rockhampton,2017,12,1/12/17,45239,0,45239
Rockhampton,2018,1,1/1/18,40418,0,40418
Rockhampton,2018,2,1/2/18,38745,0,38745
Rockhampton,2018,3,1/3/18,47560,0,47560
Rockhampton,2018,4,1/4/18,43219,0,43219
Rockhampton,2018,5,1/5/18,51992,0,51992
Rockhampton,2018,6,1/6/18,45776,0,45776
Rockhampton,2018,7,1/7/18,47491,0,47491
Rockhampton,2018,8,1/8/18,50029,0,50029
Rockhampton,2018,9,1/9/18,46663,0,46663
Rockhampton,2018,10,1/10/18,49297,0,49297
Rockhampton,2018,11,1/11/18,45955,0,45955
Rockhampton,2018,12,1/12/18,44451,0,44451
Rockhampton,2019,1,1/1/19,40930,0,40930
Rockhampton,2019,2,1/2/19,40514,0,40514
Sunshine Coast,2009,1,1/1/09,93362,0,93362
Sunshine Coast,2009,2,1/2/09,63218,0,63218
Sunshine Coast,2009,3,1/3/09,71787,0,71787
Sunshine Coast,2009,4,1/4/09,75437,0,75437
Sunshine Coast,2009,5,1/5/09,68381,0,68381
Sunshine Coast,2009,6,1/6/09,62643,0,62643
Sunshine Coast,2009,7,1/7/09,70486,0,70486
Sunshine Coast,2009,8,1/8/09,71807,0,71807
Sunshine Coast,2009,9,1/9/09,69520,0,69520
Sunshine Coast,2009,10,1/10/09,76217,0,76217
Sunshine Coast,2009,11,1/11/09,70760,0,70760
Sunshine Coast,2009,12,1/12/09,65389,0,65389
Sunshine Coast,2010,1,1/1/10,72230,0,72230
Sunshine Coast,2010,2,1/2/10,57944,0,57944
Sunshine Coast,2010,3,1/3/10,62391,0,62391
Sunshine Coast,2010,4,1/4/10,71662,0,71662
Sunshine Coast,2010,5,1/5/10,62952,0,62952
Sunshine Coast,2010,6,1/6/10,61048,0,61048
Sunshine Coast,2010,7,1/7/10,77453,0,77453
Sunshine Coast,2010,8,1/8/10,72808,0,72808
Sunshine Coast,2010,9,1/9/10,77583,0,77583
Sunshine Coast,2010,10,1/10/10,84605,0,84605
Sunshine Coast,2010,11,1/11/10,80093,0,80093
Sunshine Coast,2010,12,1/12/10,82900,0,82900
Sunshine Coast,2011,1,1/1/11,89194,0,89194
Sunshine Coast,2011,2,1/2/11,60808,0,60808
Sunshine Coast,2011,3,1/3/11,71818,0,71818
Sunshine Coast,2011,4,1/4/11,85790,0,85790
Sunshine Coast,2011,5,1/5/11,68820,0,68820
Sunshine Coast,2011,6,1/6/11,62303,0,62303
Sunshine Coast,2011,7,1/7/11,76530,0,76530
Sunshine Coast,2011,8,1/8/11,64266,0,64266
Sunshine Coast,2011,9,1/9/11,70035,0,70035
Sunshine Coast,2011,10,1/10/11,71396,0,71396
Sunshine Coast,2011,11,1/11/11,64825,0,64825
Sunshine Coast,2011,12,1/12/11,71630,0,71630
Sunshine Coast,2012,1,1/1/12,79420,0,79420
Sunshine Coast,2012,2,1/2/12,54322,0,54322
Sunshine Coast,2012,3,1/3/12,59557,0,59557
Sunshine Coast,2012,4,1/4/12,65560,0,65560
Sunshine Coast,2012,5,1/5/12,57488,0,57488
Sunshine Coast,2012,6,1/6/12,56080,0,56080
Sunshine Coast,2012,7,1/7/12,67608,2284,69892
Sunshine Coast,2012,8,1/8/12,59358,2032,61390
Sunshine Coast,2012,9,1/9/12,73355,1397,74752
Sunshine Coast,2012,10,1/10/12,73165,0,73165
Sunshine Coast,2012,11,1/11/12,70945,0,70945
Sunshine Coast,2012,12,1/12/12,72804,0,72804
Sunshine Coast,2013,1,1/1/13,74443,0,74443
Sunshine Coast,2013,2,1/2/13,49370,0,49370
Sunshine Coast,2013,3,1/3/13,62961,0,62961
Sunshine Coast,2013,4,1/4/13,73488,0,73488
Sunshine Coast,2013,5,1/5/13,59963,0,59963
Sunshine Coast,2013,6,1/6/13,64970,840,65810
Sunshine Coast,2013,7,1/7/13,74897,2233,77130
Sunshine Coast,2013,8,1/8/13,72365,2026,74391
Sunshine Coast,2013,9,1/9/13,80377,2264,82641
Sunshine Coast,2013,10,1/10/13,83004,1042,84046
Sunshine Coast,2013,11,1/11/13,78130,0,78130
Sunshine Coast,2013,12,1/12/13,84131,0,84131
Sunshine Coast,2014,1,1/1/14,89715,0,89715
Sunshine Coast,2014,2,1/2/14,58894,0,58894
Sunshine Coast,2014,3,1/3/14,70758,0,70758
Sunshine Coast,2014,4,1/4/14,76433,0,76433
Sunshine Coast,2014,5,1/5/14,62094,0,62094
Sunshine Coast,2014,6,1/6/14,62509,461,62970
Sunshine Coast,2014,7,1/7/14,74241,2711,76952
Sunshine Coast,2014,8,1/8/14,64748,2564,67312
Sunshine Coast,2014,9,1/9/14,75793,2444,78237
Sunshine Coast,2014,10,1/10/14,80669,2068,82737
Sunshine Coast,2014,11,1/11/14,72331,0,72331
Sunshine Coast,2014,12,1/12/14,73915,0,73915
Sunshine Coast,2015,1,1/1/15,79938,0,79938
Sunshine Coast,2015,2,1/2/15,52182,0,52182
Sunshine Coast,2015,3,1/3/15,64444,0,64444
Sunshine Coast,2015,4,1/4/15,74845,0,74845
Sunshine Coast,2015,5,1/5/15,59923,0,59923
Sunshine Coast,2015,6,1/6/15,64649,441,65090
Sunshine Coast,2015,7,1/7/15,79502,3152,82654
Sunshine Coast,2015,8,1/8/15,74155,3195,77350
Sunshine Coast,2015,9,1/9/15,85823,3236,89059
Sunshine Coast,2015,10,1/10/15,88371,2237,90608
Sunshine Coast,2015,11,1/11/15,79122,0,79122
Sunshine Coast,2015,12,1/12/15,85152,1337,86489
Sunshine Coast,2016,1,1/1/16,89602,2188,91790
Sunshine Coast,2016,2,1/2/16,63086,1590,64676
Sunshine Coast,2016,3,1/3/16,75739,0,75739
Sunshine Coast,2016,4,1/4/16,81708,0,81708
Sunshine Coast,2016,5,1/5/16,68480,0,68480
Sunshine Coast,2016,6,1/6/16,70444,0,70444
Sunshine Coast,2016,7,1/7/16,91050,3546,94596
Sunshine Coast,2016,8,1/8/16,76876,3252,80128
Sunshine Coast,2016,9,1/9/16,90690,3640,94330
Sunshine Coast,2016,10,1/10/16,96568,3290,99858
Sunshine Coast,2016,11,1/11/16,91086,0,91086
Sunshine Coast,2016,12,1/12/16,97423,0,97423
Sunshine Coast,2017,1,1/1/17,103183,0,103183
Sunshine Coast,2017,2,1/2/17,69264,0,69264
Sunshine Coast,2017,3,1/3/17,81035,0,81035
Sunshine Coast,2017,4,1/4/17,100871,0,100871
Sunshine Coast,2017,5,1/5/17,74861,0,74861
Sunshine Coast,2017,6,1/6/17,74819,0,74819
Sunshine Coast,2017,7,1/7/17,100550,3303,103853
Sunshine Coast,2017,8,1/8/17,85528,3239,88767
Sunshine Coast,2017,9,1/9/17,100873,3570,104443
Sunshine Coast,2017,10,1/10/17,110578,3607,114185
Sunshine Coast,2017,11,1/11/17,101006,0,101006
Sunshine Coast,2017,12,1/12/17,110397,0,110397
Sunshine Coast,2018,1,1/1/18,119654,0,119654
Sunshine Coast,2018,2,1/2/18,80087,0,80087
Sunshine Coast,2018,3,1/3/18,95146,0,95146
Sunshine Coast,2018,4,1/4/18,103331,0,103331
Sunshine Coast,2018,5,1/5/18,84546,0,84546
Sunshine Coast,2018,6,1/6/18,83473,0,83473
Sunshine Coast,2018,7,1/7/18,109626,3323,112949
Sunshine Coast,2018,8,1/8/18,103119,4166,107285
Sunshine Coast,2018,9,1/9/18,108273,3645,111918
Sunshine Coast,2018,10,1/10/18,114720,3169,117889
Sunshine Coast,2018,11,1/11/18,106534,0,106534
Sunshine Coast,2018,12,1/12/18,112093,0,112093
Sunshine Coast,2019,1,1/1/19,117350,0,117350
Sunshine Coast,2019,2,1/2/19,78736,0,78736
Sydney,2009,1,1/1/09,1847513,996457,2843970
Sydney,2009,2,1/2/09,1673605,801924,2475529
Sydney,2009,3,1/3/09,1874832,821693,2696525
Sydney,2009,4,1/4/09,1841321,870622,2711943
Sydney,2009,5,1/5/09,1718158,759410,2477568
Sydney,2009,6,1/6/09,1648040,767888,2415928
Sydney,2009,7,1/7/09,1891155,941348,2832503
Sydney,2009,8,1/8/09,1882043,864145,2746188
Sydney,2009,9,1/9/09,1912421,879689,2792110
Sydney,2009,10,1/10/09,2097780,975493,3073273
Sydney,2009,11,1/11/09,2002516,894245,2896761
Sydney,2009,12,1/12/09,1973388,1062356,3035744
Sydney,2010,1,1/1/10,1892143,1110678,3002821
Sydney,2010,2,1/2/10,1877359,899053,2776412
Sydney,2010,3,1/3/10,2051486,926343,2977829
Sydney,2010,4,1/4/10,1998206,886880,2885086
Sydney,2010,5,1/5/10,1904291,803140,2707431
Sydney,2010,6,1/6/10,1868120,867125,2735245
Sydney,2010,7,1/7/10,2082684,1015800,3098484
Sydney,2010,8,1/8/10,2033255,928432,2961687
Sydney,2010,9,1/9/10,2059553,962454,3022007
Sydney,2010,10,1/10/10,2189947,1008887,3198834
Sydney,2010,11,1/11/10,2108590,944323,3052913
Sydney,2010,12,1/12/10,2129048,1102422,3231470
Sydney,2011,1,1/1/11,1987061,1159333,3146394
Sydney,2011,2,1/2/11,1854859,916286,2771145
Sydney,2011,3,1/3/11,2073799,902945,2976744
Sydney,2011,4,1/4/11,2039393,966189,3005582
Sydney,2011,5,1/5/11,1948541,852753,2801294
Sydney,2011,6,1/6/11,1807246,884489,2691735
Sydney,2011,7,1/7/11,2064177,1040159,3104336
Sydney,2011,8,1/8/11,2004177,938127,2942304
Sydney,2011,9,1/9/11,2009250,994485,3003735
Sydney,2011,10,1/10/11,2059808,1030429,3090237
Sydney,2011,11,1/11/11,2043114,952162,2995276
Sydney,2011,12,1/12/11,2033926,1111225,3145151
Sydney,2012,1,1/1/12,1971282,1180898,3152180
Sydney,2012,2,1/2/12,1854942,940980,2795922
Sydney,2012,3,1/3/12,2076967,972317,3049284
Sydney,2012,4,1/4/12,2004321,1001330,3005651
Sydney,2012,5,1/5/12,1957081,876247,2833328
Sydney,2012,6,1/6/12,1890449,978946,2869395
Sydney,2012,7,1/7/12,2114585,1076643,3191228
Sydney,2012,8,1/8/12,2101971,1004945,3106916
Sydney,2012,9,1/9/12,2123520,1056072,3179592
Sydney,2012,10,1/10/12,2218802,1063489,3282291
Sydney,2012,11,1/11/12,2192255,1025650,3217905
Sydney,2012,12,1/12/12,2132702,1191676,3324378
Sydney,2013,1,1/1/13,2062182,1210566,3272748
Sydney,2013,2,1/2/13,1878746,974278,2853024
Sydney,2013,3,1/3/13,2114483,1040515,3154998
Sydney,2013,4,1/4/13,2103360,1028008,3131368
Sydney,2013,5,1/5/13,1995550,936254,2931804
Sydney,2013,6,1/6/13,1946797,1009456,2956253
Sydney,2013,7,1/7/13,2203768,1139675,3343443
Sydney,2013,8,1/8/13,2134712,1065538,3200250
Sydney,2013,9,1/9/13,2103628,1097430,3201058
Sydney,2013,10,1/10/13,2294181,1108398,3402579
Sydney,2013,11,1/11/13,2169189,1073009,3242198
Sydney,2013,12,1/12/13,2210065,1250758,3460823
Sydney,2014,1,1/1/14,2148823,1306985,3455808
Sydney,2014,2,1/2/14,1919917,1037233,2957150
Sydney,2014,3,1/3/14,2140302,1044328,3184630
Sydney,2014,4,1/4/14,2101306,1093236,3194542
Sydney,2014,5,1/5/14,2019327,992357,3011684
Sydney,2014,6,1/6/14,1945647,1029492,2975139
Sydney,2014,7,1/7/14,2178146,1142090,3320236
Sydney,2014,8,1/8/14,2128691,1076431,3205122
Sydney,2014,9,1/9/14,2127562,1089560,3217122
Sydney,2014,10,1/10/14,2347061,1135801,3482862
Sydney,2014,11,1/11/14,2171234,1088600,3259834
Sydney,2014,12,1/12/14,2189091,1279722,3468813
Sydney,2015,1,1/1/15,2086423,1326387,3412810
Sydney,2015,2,1/2/15,1943694,1066363,3010057
Sydney,2015,3,1/3/15,2200850,1136718,3337568
Sydney,2015,4,1/4/15,2114810,1099065,3213875
Sydney,2015,5,1/5/15,2046769,1007863,3054632
Sydney,2015,6,1/6/15,1979017,1060056,3039073
Sydney,2015,7,1/7/15,2273885,1210977,3484862
Sydney,2015,8,1/8/15,2145995,1120885,3266880
Sydney,2015,9,1/9/15,2197135,1152403,3349538
Sydney,2015,10,1/10/15,2342707,1191437,3534144
Sydney,2015,11,1/11/15,2262498,1150341,3412839
Sydney,2015,12,1/12/15,2303836,1388733,3692569
Sydney,2016,1,1/1/16,2218150,1457786,3675936
Sydney,2016,2,1/2/16,2111123,1204556,3315679
Sydney,2016,3,1/3/16,2298486,1226541,3525027
Sydney,2016,4,1/4/16,2226650,1214946,3441596
Sydney,2016,5,1/5/16,2127391,1082798,3210189
Sydney,2016,6,1/6/16,2055379,1140791,3196170
Sydney,2016,7,1/7/16,2332285,1347109,3679394
Sydney,2016,8,1/8/16,2209052,1210752,3419804
Sydney,2016,9,1/9/16,2285326,1247507,3532833
Sydney,2016,10,1/10/16,2377514,1281541,3659055
Sydney,2016,11,1/11/16,2337440,1228753,3566193
Sydney,2016,12,1/12/16,2327148,1468897,3796045
Sydney,2017,1,1/1/17,2255527,1559969,3815496
Sydney,2017,2,1/2/17,2058044,1225869,3283913
Sydney,2017,3,1/3/17,2330826,1243785,3574611
Sydney,2017,4,1/4/17,2243073,1346092,3589165
Sydney,2017,5,1/5/17,2181077,1156617,3337694
Sydney,2017,6,1/6/17,2117148,1242871,3360019
Sydney,2017,7,1/7/17,2368234,1423033,3791267
Sydney,2017,8,1/8/17,2236341,1300543,3536884
Sydney,2017,9,1/9/17,2269844,1327350,3597194
Sydney,2017,10,1/10/17,2444126,1345502,3789628
Sydney,2017,11,1/11/17,2410803,1311556,3722359
Sydney,2017,12,1/12/17,2376831,1554999,3931830
Sydney,2018,1,1/1/18,2295333,1586333,3881666
Sydney,2018,2,1/2/18,2137861,1314012,3451873
Sydney,2018,3,1/3/18,2412959,1369182,3782141
Sydney,2018,4,1/4/18,2314158,1373416,3687574
Sydney,2018,5,1/5/18,2209018,1229871,3438889
Sydney,2018,6,1/6/18,2128329,1295198,3423527
Sydney,2018,7,1/7/18,2402625,1489983,3892608
Sydney,2018,8,1/8/18,2326064,1362107,3688171
Sydney,2018,9,1/9/18,2259795,1357595,3617390
Sydney,2018,10,1/10/18,2482712,1436293,3919005
Sydney,2018,11,1/11/18,2381598,1347275,3728873
Sydney,2018,12,1/12/18,2316821,1601220,3918041
Sydney,2019,1,1/1/19,2289327,1656401,3945728
Sydney,2019,2,1/2/19,2082995,1320912,3403907
Townsville,2009,1,1/1/09,106599,0,106599
Townsville,2009,2,1/2/09,94011,0,94011
Townsville,2009,3,1/3/09,113426,0,113426
Townsville,2009,4,1/4/09,121841,0,121841
Townsville,2009,5,1/5/09,128393,0,128393
Townsville,2009,6,1/6/09,126795,0,126795
Townsville,2009,7,1/7/09,143254,0,143254
Townsville,2009,8,1/8/09,133406,0,133406
Townsville,2009,9,1/9/09,129884,0,129884
Townsville,2009,10,1/10/09,133483,0,133483
Townsville,2009,11,1/11/09,125668,0,125668
Townsville,2009,12,1/12/09,125470,0,125470
Townsville,2010,1,1/1/10,111777,0,111777
Townsville,2010,2,1/2/10,108963,0,108963
Townsville,2010,3,1/3/10,120645,0,120645
Townsville,2010,4,1/4/10,125738,0,125738
Townsville,2010,5,1/5/10,126423,0,126423
Townsville,2010,6,1/6/10,133658,0,133658
Townsville,2010,7,1/7/10,148723,0,148723
Townsville,2010,8,1/8/10,146100,0,146100
Townsville,2010,9,1/9/10,144793,0,144793
Townsville,2010,10,1/10/10,146069,0,146069
Townsville,2010,11,1/11/10,132767,0,132767
Townsville,2010,12,1/12/10,143094,1314,144408
Townsville,2011,1,1/1/11,119392,1942,121334
Townsville,2011,2,1/2/11,103941,1160,105101
Townsville,2011,3,1/3/11,133861,1154,135015
Townsville,2011,4,1/4/11,133258,1004,134262
Townsville,2011,5,1/5/11,136110,845,136955
Townsville,2011,6,1/6/11,134134,754,134888
Townsville,2011,7,1/7/11,150716,1125,151841
Townsville,2011,8,1/8/11,142518,740,143258
Townsville,2011,9,1/9/11,143180,766,143946
Townsville,2011,10,1/10/11,139427,102,139529
Townsville,2011,11,1/11/11,133051,0,133051
Townsville,2011,12,1/12/11,137703,0,137703
Townsville,2012,1,1/1/12,119347,0,119347
Townsville,2012,2,1/2/12,117506,0,117506
Townsville,2012,3,1/3/12,132720,0,132720
Townsville,2012,4,1/4/12,131782,0,131782
Townsville,2012,5,1/5/12,137363,0,137363
Townsville,2012,6,1/6/12,138525,0,138525
Townsville,2012,7,1/7/12,147071,0,147071
Townsville,2012,8,1/8/12,138717,0,138717
Townsville,2012,9,1/9/12,136210,0,136210
Townsville,2012,10,1/10/12,143314,0,143314
Townsville,2012,11,1/11/12,133249,0,133249
Townsville,2012,12,1/12/12,133934,0,133934
Townsville,2013,1,1/1/13,118412,0,118412
Townsville,2013,2,1/2/13,107619,0,107619
Townsville,2013,3,1/3/13,123296,0,123296
Townsville,2013,4,1/4/13,127312,0,127312
Townsville,2013,5,1/5/13,128589,0,128589
Townsville,2013,6,1/6/13,131996,0,131996
Townsville,2013,7,1/7/13,148020,0,148020
Townsville,2013,8,1/8/13,137315,0,137315
Townsville,2013,9,1/9/13,137805,0,137805
Townsville,2013,10,1/10/13,140343,0,140343
Townsville,2013,11,1/11/13,120887,0,120887
Townsville,2013,12,1/12/13,134985,0,134985
Townsville,2014,1,1/1/14,112198,0,112198
Townsville,2014,2,1/2/14,100711,0,100711
Townsville,2014,3,1/3/14,115781,0,115781
Townsville,2014,4,1/4/14,122260,0,122260
Townsville,2014,5,1/5/14,123849,0,123849
Townsville,2014,6,1/6/14,128778,0,128778
Townsville,2014,7,1/7/14,142439,0,142439
Townsville,2014,8,1/8/14,132001,0,132001
Townsville,2014,9,1/9/14,134422,0,134422
Townsville,2014,10,1/10/14,136139,0,136139
Townsville,2014,11,1/11/14,117175,0,117175
Townsville,2014,12,1/12/14,132088,0,132088
Townsville,2015,1,1/1/15,111909,0,111909
Townsville,2015,2,1/2/15,98439,0,98439
Townsville,2015,3,1/3/15,117998,0,117998
Townsville,2015,4,1/4/15,123844,0,123844
Townsville,2015,5,1/5/15,124026,0,124026
Townsville,2015,6,1/6/15,127577,0,127577
Townsville,2015,7,1/7/15,145023,0,145023
Townsville,2015,8,1/8/15,131085,0,131085
Townsville,2015,9,1/9/15,134709,2809,137518
Townsville,2015,10,1/10/15,135679,3535,139214
Townsville,2015,11,1/11/15,121111,1229,122340
Townsville,2015,12,1/12/15,128711,3550,132261
Townsville,2016,1,1/1/16,111824,3234,115058
Townsville,2016,2,1/2/16,98163,2722,100885
Townsville,2016,3,1/3/16,117129,3159,120288
Townsville,2016,4,1/4/16,120629,3021,123650
Townsville,2016,5,1/5/16,125967,3618,129585
Townsville,2016,6,1/6/16,129767,3707,133474
Townsville,2016,7,1/7/16,142861,3892,146753
Townsville,2016,8,1/8/16,130264,3409,133673
Townsville,2016,9,1/9/16,134845,3703,138548
Townsville,2016,10,1/10/16,129537,3895,133432
Townsville,2016,11,1/11/16,118389,3286,121675
Townsville,2016,12,1/12/16,128625,3833,132458
Townsville,2017,1,1/1/17,111180,3847,115027
Townsville,2017,2,1/2/17,96830,3271,100101
Townsville,2017,3,1/3/17,115121,3235,118356
Townsville,2017,4,1/4/17,126737,4282,131019
Townsville,2017,5,1/5/17,122567,4324,126891
Townsville,2017,6,1/6/17,132681,4229,136910
Townsville,2017,7,1/7/17,150468,4909,155377
Townsville,2017,8,1/8/17,140606,4604,145210
Townsville,2017,9,1/9/17,139916,4565,144481
Townsville,2017,10,1/10/17,139884,4378,144262
Townsville,2017,11,1/11/17,128802,3369,132171
Townsville,2017,12,1/12/17,136698,3522,140220
Townsville,2018,1,1/1/18,120185,4606,124791
Townsville,2018,2,1/2/18,104371,4320,108691
Townsville,2018,3,1/3/18,135166,3099,138265
Townsville,2018,4,1/4/18,127310,858,128168
Townsville,2018,5,1/5/18,133949,547,134496
Townsville,2018,6,1/6/18,130112,693,130805
Townsville,2018,7,1/7/18,159435,808,160243
Townsville,2018,8,1/8/18,146577,672,147249
Townsville,2018,9,1/9/18,137187,584,137771
Townsville,2018,10,1/10/18,140204,0,140204
Townsville,2018,11,1/11/18,129096,0,129096
Townsville,2018,12,1/12/18,130519,0,130519
Townsville,2019,1,1/1/19,118189,0,118189
Townsville,2019,2,1/2/19,100266,0,100266
All Australian Airports,2009,1,1/1/09,8316460,2249424,10565884
All Australian Airports,2009,2,1/2/09,7238300,1793147,9031447
All Australian Airports,2009,3,1/3/09,8319008,1871540,10190548
All Australian Airports,2009,4,1/4/09,8275542,1975608,10251150
All Australian Airports,2009,5,1/5/09,7876608,1764508,9641116
All Australian Airports,2009,6,1/6/09,7582058,1829895,9411953
All Australian Airports,2009,7,1/7/09,8552960,2139351,10692311
All Australian Airports,2009,8,1/8/09,8396528,1999799,10396327
All Australian Airports,2009,9,1/9/09,8521298,2086767,10608065
All Australian Airports,2009,10,1/10/09,8999378,2217762,11217140
All Australian Airports,2009,11,1/11/09,8530380,2075908,10606288
All Australian Airports,2009,12,1/12/09,8417658,2403191,10820849
All Australian Airports,2010,1,1/1/10,8170184,2482669,10652853
All Australian Airports,2010,2,1/2/10,7822194,2030127,9852321
All Australian Airports,2010,3,1/3/10,8816840,2145529,10962369
All Australian Airports,2010,4,1/4/10,8703608,2062773,10766381
All Australian Airports,2010,5,1/5/10,8306804,1886099,10192903
All Australian Airports,2010,6,1/6/10,8315806,2095679,10411485
All Australian Airports,2010,7,1/7/10,9266286,2401136,11667422
All Australian Airports,2010,8,1/8/10,9038618,2213745,11252363
All Australian Airports,2010,9,1/9/10,9226780,2316363,11543143
All Australian Airports,2010,10,1/10/10,9663202,2373199,12036401
All Australian Airports,2010,11,1/11/10,9196712,2205642,11402354
All Australian Airports,2010,12,1/12/10,9383700,2577354,11961054
All Australian Airports,2011,1,1/1/11,8774582,2709123,11483705
All Australian Airports,2011,2,1/2/11,7845168,2120226,9965394
All Australian Airports,2011,3,1/3/11,9069790,2111623,11181413
All Australian Airports,2011,4,1/4/11,9049750,2285449,11335199
All Australian Airports,2011,5,1/5/11,8756154,2079485,10835639
All Australian Airports,2011,6,1/6/11,8188636,2155944,10344580
All Australian Airports,2011,7,1/7/11,9368226,2531894,11900120
All Australian Airports,2011,8,1/8/11,9099846,2308924,11408770
All Australian Airports,2011,9,1/9/11,9094122,2401935,11496057
All Australian Airports,2011,10,1/10/11,9382632,2476335,11858967
All Australian Airports,2011,11,1/11/11,9154462,2302972,11457434
All Australian Airports,2011,12,1/12/11,9110428,2671099,11781527
All Australian Airports,2012,1,1/1/12,8944232,2803526,11747758
All Australian Airports,2012,2,1/2/12,8242428,2220767,10463195
All Australian Airports,2012,3,1/3/12,9305268,2325361,11630629
All Australian Airports,2012,4,1/4/12,9057790,2379244,11437034
All Australian Airports,2012,5,1/5/12,8919608,2099103,11018711
All Australian Airports,2012,6,1/6/12,8710602,2361188,11071790
All Australian Airports,2012,7,1/7/12,9676804,2595183,12271987
All Australian Airports,2012,8,1/8/12,9507058,2418677,11925735
All Australian Airports,2012,9,1/9/12,9574306,2532916,12107222
All Australian Airports,2012,10,1/10/12,10079832,2572716,12652548
All Australian Airports,2012,11,1/11/12,9795878,2450674,12246552
All Australian Airports,2012,12,1/12/12,9490652,2849637,12340289
All Australian Airports,2013,1,1/1/13,9255974,2887496,12143470
All Australian Airports,2013,2,1/2/13,8256730,2313309,10570039
All Australian Airports,2013,3,1/3/13,9448022,2497251,11945273
All Australian Airports,2013,4,1/4/13,9457206,2449934,11907140
All Australian Airports,2013,5,1/5/13,9006082,2274189,11280271
All Australian Airports,2013,6,1/6/13,8869878,2467916,11337794
All Australian Airports,2013,7,1/7/13,10104312,2795406,12899718
All Australian Airports,2013,8,1/8/13,9690888,2644290,12335178
All Australian Airports,2013,9,1/9/13,9577030,2680985,12258015
All Australian Airports,2013,10,1/10/13,10359050,2709608,13068658
All Australian Airports,2013,11,1/11/13,9612210,2553483,12165693
All Australian Airports,2013,12,1/12/13,9853546,3070649,12924195
All Australian Airports,2014,1,1/1/14,9580584,3201609,12782193
All Australian Airports,2014,2,1/2/14,8413870,2490343,10904213
All Australian Airports,2014,3,1/3/14,9489838,2531778,12021616
All Australian Airports,2014,4,1/4/14,9514764,2709932,12224696
All Australian Airports,2014,5,1/5/14,9057492,2448609,11506101
All Australian Airports,2014,6,1/6/14,8894146,2585441,11479587
All Australian Airports,2014,7,1/7/14,9996582,2957222,12953804
All Australian Airports,2014,8,1/8/14,9592076,2744275,12336351
All Australian Airports,2014,9,1/9/14,9610186,2781028,12391214
All Australian Airports,2014,10,1/10/14,10477524,2854559,13332083
All Australian Airports,2014,11,1/11/14,9534382,2668537,12202919
All Australian Airports,2014,12,1/12/14,9771498,3159755,12931253
All Australian Airports,2015,1,1/1/15,9261524,3282915,12544439
All Australian Airports,2015,2,1/2/15,8366126,2651565,11017691
All Australian Airports,2015,3,1/3/15,9584080,2802213,12386293
All Australian Airports,2015,4,1/4/15,9444866,2746515,12191381
All Australian Airports,2015,5,1/5/15,9003498,2527461,11530959
All Australian Airports,2015,6,1/6/15,8865434,2688592,11554026
All Australian Airports,2015,7,1/7/15,10226320,3089421,13315741
All Australian Airports,2015,8,1/8/15,9534626,2870955,12405581
All Australian Airports,2015,9,1/9/15,9733756,2933459,12667215
All Australian Airports,2015,10,1/10/15,10317152,3022122,13339274
All Australian Airports,2015,11,1/11/15,9835410,2823632,12659042
All Australian Airports,2015,12,1/12/15,10056560,3427799,13484359
All Australian Airports,2016,1,1/1/16,9585532,3560271,13145803
All Australian Airports,2016,2,1/2/16,8881300,2935682,11816982
All Australian Airports,2016,3,1/3/16,9897144,3009317,12906461
All Australian Airports,2016,4,1/4/16,9627012,2959262,12586274
All Australian Airports,2016,5,1/5/16,9275816,2690863,11966679
All Australian Airports,2016,6,1/6/16,9157288,2905948,12063236
All Australian Airports,2016,7,1/7/16,10312870,3407850,13720720
All Australian Airports,2016,8,1/8/16,9713032,3063012,12776044
All Australian Airports,2016,9,1/9/16,10058464,3175613,13234077
All Australian Airports,2016,10,1/10/16,10420118,3225758,13645876
All Australian Airports,2016,11,1/11/16,10043856,3025559,13069415
All Australian Airports,2016,12,1/12/16,10216170,3657618,13873788
All Australian Airports,2017,1,1/1/17,9887058,3802113,13689171
All Australian Airports,2017,2,1/2/17,8653900,2970635,11624535
All Australian Airports,2017,3,1/3/17,9942442,3059339,13001781
All Australian Airports,2017,4,1/4/17,9815284,3307826,13123110
All Australian Airports,2017,5,1/5/17,9423080,2871230,12294310
All Australian Airports,2017,6,1/6/17,9322072,3094393,12416465
All Australian Airports,2017,7,1/7/17,10537100,3540914,14078014
All Australian Airports,2017,8,1/8/17,9893950,3250087,13144037
All Australian Airports,2017,9,1/9/17,10072534,3330398,13402932
All Australian Airports,2017,10,1/10/17,10767902,3369928,14137830
All Australian Airports,2017,11,1/11/17,10361670,3191909,13553579
All Australian Airports,2017,12,1/12/17,10420156,3826935,14247091
All Australian Airports,2018,1,1/1/18,10087998,3885401,13973399
All Australian Airports,2018,2,1/2/18,9009336,3187620,12196956
All Australian Airports,2018,3,1/3/18,10381216,3370279,13751495
All Australian Airports,2018,4,1/4/18,10079632,3362133,13441765
All Australian Airports,2018,5,1/5/18,9645110,3026652,12671762
All Australian Airports,2018,6,1/6/18,9351292,3276906,12628198
All Australian Airports,2018,7,1/7/18,10794498,3711115,14505613
All Australian Airports,2018,8,1/8/18,10286610,3469473,13756083
All Australian Airports,2018,9,1/9/18,10080778,3462722,13543500
All Australian Airports,2018,10,1/10/18,10904946,3547757,14452703
All Australian Airports,2018,11,1/11/18,10372794,3324676,13697470
All Australian Airports,2018,12,1/12/18,10203362,3950579,14153941
All Australian Airports,2019,1,1/1/19,10054672,4073072,14127744
All Australian Airports,2019,2,1/2/19,8926364,3256808,12183172